unique_id, Restuarant_Name, Longitude, Latitude, Price_Index, Num_Shown_5_star, Num_Shown_4_star, Num_Shown_3_star, Num_Shown_2_star, Num_Shown_1_star, Total_Shown_Votes, Avg_Shown_Score, Num_Filtered_5_star, Num_Filtered_4_star, Num_Filtered_3_star, Num_Filtered_2_star, Num_Filtered_1_star, Total_Filtered_Votes, Avg_Filtered_Score
d0XtFPtDQhlXXTY-9uCxAA,Taqueria Traspasada,41.9389527,-87.6979428,1,45,54,9,6,8,122,4.0,12,6,2,0,1,21,4.333333333333333
jLeoiyhxx5FyGmtuYpdQnQ,Pho No.1,41.9679385904684,-87.7754132153047,1,62,31,8,4,5,110,4.281818181818182,3,2,0,2,1,8,3.5
LXtSheHGNVAjY8DUMy9pqA,New York Delicatessen,41.9353856,-87.6467644,1,147,55,16,8,4,230,4.447826086956522,42,8,1,1,7,59,4.305084745762712
8oKRLk54AhYwEaBe7onYog,Green Door Tavern,41.8946215100706,-87.6373652708838,2,79,157,69,12,12,329,3.8480243161094223,14,14,1,0,2,31,4.225806451612903
CwPi6NVuJIZZx4IBcTekFQ,Yolk South Loop,41.868802670386,-87.624455337994,2,418,473,251,116,43,1301,3.850883935434281,54,69,20,11,16,170,3.788235294117647
JkSMTKASXhXmMJK5qcCJiQ,The Orbit Room,41.9356631,-87.6975722,2,107,123,37,20,11,298,3.98993288590604,22,13,3,2,13,53,3.547169811320755
kxqcvZTKm2FAt6c5JNViNw,Brgrbelly,41.985086,-87.7761971,2,108,23,14,5,6,156,4.423076923076923,8,6,1,1,3,19,3.789473684210526
8sNuhJjg7fEzVY5L7nW_kg,Paco’s Tacos,41.815012,-87.702131,1,55,30,6,2,3,96,4.375,15,5,0,0,4,24,4.125
zXDVdB7jofrt1IWODlOtUA,Beatrix River North,41.891477,-87.6308169,2,393,324,88,40,23,868,4.179723502304148,25,18,2,1,2,48,4.3125
YU3XvseN8keVmipgidQ94w,Antique Taco,41.9063609,-87.671681,2,296,298,117,59,30,800,3.96375,46,24,6,5,4,85,4.211764705882353
jmb-2jtaaDXe8bYD4QLTzw,La Palma Puerto Rican Restaurant,41.9058051,-87.7119663,1,54,25,6,5,9,99,4.111111111111111,29,3,2,1,5,40,4.25
3Yw8i4DTPR5a7SpQJMMS9Q,Honky Tonk BBQ,41.8577783,-87.656753,2,190,223,107,81,60,661,3.6081694402420577,75,29,13,15,28,160,3.675
d6UbRb9W5eA1yL-DuVZ8ug,ZED451,41.896111,-87.63102,3,377,334,129,69,60,969,3.9277605779153766,71,36,7,19,37,170,3.5
q684td_kKNRMTHMeMchXOg,En Hakkore,41.91518,-87.677724,2,250,131,26,7,6,420,4.457142857142857,19,4,3,1,0,27,4.518518518518518
sQ-IPzNMgkDkF7BWb9cApw,Nohea Cafe,41.8817241,-87.6603567,2,78,57,9,5,8,157,4.222929936305732,27,8,0,5,3,43,4.186046511627907
U5qXyYimIHN5s1IXdV1qdA,Moon’s Sandwich Shop,41.8806481,-87.6867815,1,41,26,8,4,6,85,4.08235294117647,3,5,1,0,2,11,3.6363636363636362
XZwuqqN5HZ8jFAdmxQmcKg,Casa Yari,41.9249801635742,-87.7101974487305,2,57,13,1,0,3,74,4.635135135135135,6,0,1,0,2,9,3.888888888888889
bzimKESOih3WdRWa42QXMg,Perennial Virant,41.9154762,-87.6345544,3,167,149,61,39,11,427,3.988290398126464,13,5,5,7,5,35,3.4
mRHWyuwuBoNErcNbwwdjVw,Cherubs,41.925193,-87.691153,1,20,12,6,2,1,41,4.170731707317073,4,0,2,0,1,7,3.857142857142857
JVPraLjYtcNRzcfhHHNOhQ,The Grafton,41.9639855,-87.6857255,2,119,196,67,33,15,430,3.8627906976744186,21,17,2,3,5,48,3.9583333333333335
0VEE9H6OuGaswhC70tjKeQ,Beatrix Streeterville,41.8944538,-87.6227298,2,58,25,10,6,3,102,4.264705882352941,10,1,0,0,0,11,4.909090909090909
uFsyh2CRpIWYOaT_FfiHtg,Blue Door Farm Stand Too,41.9180765,-87.6466439,2,11,0,0,0,0,11,5.0,0,0,0,0,0,0,x
ElCbMJRjgu9LDj4MxOKXew,Big Jones,41.9794385,-87.6680092,2,330,421,189,110,32,1082,3.8382624768946396,51,29,17,16,15,128,3.6640625
Y0FD11PwniiZdMHvjIaplw,Ugo’s Kitchen & Bar,41.9173118757641,-87.6987504834681,2,27,5,4,2,1,39,4.410256410256411,5,0,0,0,0,5,5.0
QG6k8viDLaAf5WBIytthDA,Jess Cafe,41.9382945,-87.7722116,1,132,81,18,15,14,260,4.161538461538462,22,8,2,4,3,39,4.076923076923077
cKZNbMvoqJaUe7n6lf6i7w,Wildberry Pancakes and Cafe,41.884596215642,-87.6230798295251,2,1106,598,184,63,30,1981,4.356385663806159,113,49,11,9,43,225,3.8
0WqF9QEQBgNHNr3WXmwS6g,Jubrano’s,41.86906,-87.664896,1,34,33,13,7,2,89,4.01123595505618,16,7,0,0,1,24,4.541666666666667
aSxxfNO_647MtX8zc6vhOg,Angelina Ristorante,41.947681,-87.646998,2,174,188,75,48,23,508,3.87007874015748,18,25,7,10,9,69,3.4782608695652173
FqzYCiJ29FGw6KFAGrpuJQ,Lou Malnati’s Pizzeria,41.9025154,-87.6284023,2,309,238,86,41,34,708,4.055084745762712,33,25,11,6,8,83,3.8313253012048194
B5CpZsEZJqRsKVYU7nWDDg,The Aberdeen Tap,41.89033,-87.654946,2,104,97,16,0,4,221,4.343891402714932,18,4,1,0,1,24,4.583333333333333
7zXVHfCWPnoAgU2pEbaazQ,Ara On,41.8794523179531,-87.6327513903379,2,60,70,34,14,5,183,3.907103825136612,7,9,0,0,2,18,4.055555555555555
UHUalNP0sTqDeCdXrBCAZg,Sol de Mexico,41.9357899,-87.7470853,2,102,44,18,8,6,178,4.280898876404494,27,9,1,2,3,42,4.309523809523809
-QSd8rhzCui-tZEyIfwyQA,Ñ,41.9356832,-87.6927103,2,63,72,22,23,10,190,3.8157894736842106,10,4,1,1,4,20,3.75
-iO1az8Y48qGtbbCsi_czA,Da Rae Jung,41.9765311,-87.6928183,2,136,77,17,5,3,238,4.420168067226891,14,4,0,0,1,19,4.578947368421052
4BAiPbaQCS-62BhjlkqlOA,The Blanchard,41.9174772,-87.6363236,3,34,17,7,3,4,65,4.138461538461539,4,0,0,1,1,6,3.8333333333333335
e7l0KeuIW6YfoBavU-Ptcw,Ruxbin,41.89758,-87.6669919,3,364,180,79,25,14,662,4.29154078549849,36,17,3,4,3,63,4.253968253968254
xy2FBJGECy-pxf0U9b2-eQ,Sultan’s Market,41.9284272,-87.6420285,1,172,170,60,22,11,435,4.080459770114943,28,17,3,2,6,56,4.053571428571429
F3fJg60npf7YQfY-n73P8Q,Cafe El Tapatio,41.9434776,-87.6690781,2,178,213,69,32,35,527,3.886148007590133,25,22,9,3,6,65,3.876923076923077
XqJ-TLSuIdYF0wKGK3F06w,Tacos Palas,41.859012,-87.646978,1,17,12,5,0,1,35,4.257142857142857,3,2,0,0,1,6,4.0
-kHNCSxf_lHi9822c43J7w,Ora,41.9756288,-87.6682464,2,195,73,18,14,9,309,4.394822006472492,30,8,1,0,5,44,4.318181818181818
gLcItuS3IkzGzNIq0kWgHQ,Ixcateco Grill,41.961403,-87.713415,2,40,20,3,0,0,63,4.587301587301587,3,3,0,0,1,7,4.0
bFxtGcL0W7ZNEj3NwTmM0A,Blackbird,41.8842918333133,-87.6435537582028,3,407,365,183,99,35,1089,3.9274563820018367,43,28,9,8,8,96,3.9375
FiYmu6a5yJbTmoTfvIM2nA,ORD Pizzeria,41.961566,-87.6696193,2,84,36,13,7,7,147,4.244897959183674,5,2,1,1,4,13,3.230769230769231
zNvvqQSN_CKg4dCnNc_XRw,Peach And Green,41.8811310397856,-87.6260386631488,1,29,9,8,6,3,55,4.0,8,0,0,0,1,9,4.555555555555555
ugOU_IJV4qFSaC1BtuazyQ,Sweetwater Tavern and Grille,41.886616,-87.623972,2,91,252,177,66,32,618,3.4919093851132685,16,19,10,9,10,64,3.34375
EnsfSFa422IkWwFvR1hJMQ,Duke Of Perth,41.9352605,-87.6465332,2,166,225,72,15,10,488,4.069672131147541,19,22,7,17,15,80,3.1625
oSyXCPjUhCgoTXA8VdbOTA,Kameya,41.9219186,-87.6491023,2,85,42,17,6,5,155,4.264516129032258,7,1,2,0,0,10,4.5
ZIqeTQDb26J1dnPeHGRiLA,The Bongo Room,41.8672065734863,-87.6256332397461,2,371,448,201,86,43,1149,3.885987815491732,31,31,7,8,13,90,3.6555555555555554
aEYu5fU5i2HKBOkvC9Zm7w,Ricobene’s,41.8457361,-87.6339608,1,158,149,50,34,41,432,3.8078703703703702,38,20,6,8,22,94,3.4680851063829787
9vfM3389qnOhsMYO7ec6NA,Mama Milano’s Pizza Bar,41.908183,-87.634163,2,62,26,8,9,3,108,4.25,8,0,1,0,5,14,3.4285714285714284
EeIcldvXA-V-VkXqNeWdlA,Bistro Dre,41.9358667,-87.6628925,2,108,73,19,19,32,251,3.8207171314741037,27,9,1,3,13,53,3.641509433962264
v1aNjxvElp02bRfaGieSNw,Taqueria Sabor Y Sazon,41.854669,-87.664222,1,21,5,3,2,1,32,4.34375,3,0,0,0,0,3,5.0
7Br2Xp5XBj5wYEoXWy6fRA,Twisted Tapas,42.0058573,-87.6603059,2,89,51,8,10,5,163,4.282208588957055,21,6,1,4,2,34,4.176470588235294
ZVzt6xox9mjcegvkcUxn4w,Cafe Brauer,41.919116975692,-87.6338875971283,2,26,18,6,1,1,52,4.288461538461538,5,3,2,0,3,13,3.5384615384615383
avPNh77s2rYNAkABm8MTKw,Restaurant Veneno De Nayarit,41.9004803,-87.6676598,2,167,122,32,28,44,393,3.8651399491094147,20,14,4,2,14,54,3.4444444444444446
Bmc0wjoqFH1kSBMPSrj0xw,The Red Lion Pub,41.9262503,-87.6502686,2,40,14,5,0,4,63,4.365079365079365,5,1,0,5,2,13,3.1538461538461537
57tIovgpJG-dV_uVSK4ZDg,Franks ‘N’ Dawgs,41.9150441,-87.6548019,2,290,209,81,32,28,640,4.0953125,36,8,7,8,10,69,3.753623188405797
bQaiow1WcwwSODUo9hHOMQ,RPM Italian,41.890873,-87.6301116,3,801,518,247,119,56,1741,4.085008615738081,106,63,28,31,45,273,3.5641025641025643
E974TODU6F-HCzUS02nXiQ,Tortoise Club,41.8887554967998,-87.6282440151018,3,102,83,37,23,5,250,4.016,17,4,0,1,3,25,4.24
eouoOadI4bWZqBRxWhok-w,Taza Cafe,41.88528255359,-87.635568761842,1,238,157,34,24,4,457,4.3150984682713345,29,15,2,2,3,51,4.2745098039215685
VAregVfBNLYr9qz-cexxiw,Café Orchid,41.9470664,-87.6731856,2,106,161,39,24,10,340,3.9676470588235295,36,17,2,3,7,65,4.107692307692307
hVf31CYionZPWquqKnOsUw,DiSotto Enoteca,41.8985615,-87.6213982,2,85,50,10,4,1,150,4.426666666666667,5,6,1,0,0,12,4.333333333333333
ZjHA6dwdgGXm-NjUcFezOA,BIG & little’s Restaurant,41.898386,-87.63726,2,401,322,108,65,25,921,4.095548317046688,59,27,10,9,12,117,3.9572649572649574
z8G5AfXYbJD2jQpSEF633g,Michael’s Pizzeria & Tavern,41.9567379,-87.6519191,2,151,130,44,22,13,360,4.066666666666666,20,14,1,1,2,38,4.2894736842105265
7vsOVA4wrHP6f3DMQdD8og,Volare Ristorante Italiano,41.8914584,-87.6226313,2,508,432,139,60,44,1183,4.0989010989010985,74,35,7,10,16,142,3.992957746478873
-sEO86TemAiX4Hc4x0uexw,Ponce Restaurant,41.9246378,-87.7346733,1,52,14,3,8,11,88,4.0,14,3,1,0,3,21,4.190476190476191
iV0dJWBCENr4ZiTgqK4lLQ,Southport & Irving - SIP,41.95452,-87.6644318,2,113,102,36,40,16,307,3.8338762214983713,25,7,1,4,5,42,4.023809523809524
3kuU1dISJCNFunCKDjplpg,Garifuna Flava,41.779496,-87.686937,2,106,40,11,1,2,160,4.54375,27,9,0,2,1,39,4.512820512820513
XTpzGxeVtwBi-lq6EbPhEg,El comalito,41.9226508,-87.6876507,1,12,0,1,0,0,13,4.846153846153846,1,0,0,0,0,1,5.0
qjnpkS8yZO8xcyEIy5OU9A,Girl & the Goat,41.8841049992939,-87.6479440725005,3,3037,1103,445,207,82,4874,4.396389002872384,485,204,88,33,142,952,3.9002100840336134
XgGUnYs2bjbbNvBefFtWxA,The Pasta Bowl,41.92638,-87.641448,2,237,219,68,24,34,582,4.0326460481099655,41,25,5,4,5,80,4.1625
vvhfPV-Llkd4fE2SHuLVvA,The Gage,41.8813024487444,-87.6246796858714,3,680,873,256,79,31,1919,4.090151120375196,71,68,15,10,45,209,3.526315789473684
FgscTtEHFNqnVGjubIvLXw,Lotus Cafe & Bánh Mì Sandwiches,41.8645737,-87.6458928,1,188,75,16,3,2,284,4.563380281690141,18,2,0,0,0,20,4.9
Cd-FHp9P_vxI0iHAZwsYIw,Unite Urban Grill,41.8963899,-87.66441,2,121,50,12,15,3,201,4.348258706467662,25,5,0,2,2,34,4.4411764705882355
FiJ2O5LHPfL-OyiBBazpgA,The Corned Beef Factory Sandwich Shop,41.8854532668439,-87.6526295766234,2,92,17,6,6,2,123,4.5528455284552845,11,4,0,0,0,15,4.733333333333333
Dn23mAnWMquipOt4b76fOQ,TWO,41.891282,-87.6560565,3,305,148,49,23,11,536,4.330223880597015,23,10,2,1,1,37,4.4324324324324325
Kesy2o_OiHCS6juMdXFb7A,Goose Island Shrimp House Chicago,41.9034225,-87.652858,1,38,34,23,9,11,115,3.6869565217391305,11,7,1,1,2,22,4.090909090909091
Ydf5dgFsGhMSP61Ht7TekA,Butcher & The Burger,41.9178768,-87.6543136,2,301,254,85,58,34,732,3.9972677595628414,53,32,9,11,6,111,4.036036036036036
J1e-SGNCiU02aFQ4T-u2DQ,The Bongo Room,41.973514,-87.668284,2,161,101,53,29,17,361,3.9972299168975067,12,4,3,2,2,23,3.9565217391304346
bbJOsnKN0nNkYmnDHOdAwQ,Emerald Loop,41.8863702,-87.6265311,2,43,89,108,36,26,302,3.2880794701986753,14,8,8,4,8,42,3.380952380952381
3kj0naj7ACPcVdpnygFLEQ,Rubi’s at the New Maxwell Street Market,41.8717213,-87.6440029,1,21,10,4,0,1,36,4.388888888888889,1,0,0,0,0,1,5.0
lqJvhcQBirF5J-wNC0kGuA,Woodie’s Flat,41.9102022,-87.634401,2,46,44,22,10,6,128,3.890625,0,2,1,0,0,3,3.6666666666666665
xQnuBMN92ZTq17oLTYMuPw,The Radler,41.9244284,-87.6996531,2,77,87,46,21,4,235,3.902127659574468,12,3,5,4,5,29,3.4482758620689653
o4vm4Z31Xfr-Fa8_D9EnLw,Acanto,41.8814566,-87.6248985,3,52,41,8,11,5,117,4.05982905982906,4,0,0,2,1,7,3.5714285714285716
zIXZtgiir9CVF-iZeeAvaQ,Ramen-san,41.8898027,-87.630364,2,160,225,144,75,37,641,3.6177847113884556,15,5,4,2,4,30,3.8333333333333335
_gcDPMZjM4rVO5ZVfM3xlA,Parson’s Chicken & Fish,41.9174639,-87.7010202,2,165,185,96,62,42,550,3.670909090909091,12,19,7,7,7,52,3.423076923076923
TQp4_qJFrn_aO6Y1IOZgCg,Gus’s World Famous Fried Chicken,41.8866488028888,-87.6494031537698,2,48,53,28,10,5,144,3.8958333333333335,8,2,1,0,0,11,4.636363636363637
EqYsNrxTk6YM-Qk7xWC48g,Tre Kronor,41.9759307505565,-87.7109275,2,240,205,57,19,12,533,4.204502814258912,21,16,3,2,3,45,4.111111111111111
X8DCUB7sJwlmYYQJuTF9nw,Zachi,41.9399198,-87.6641233,1,141,41,19,12,7,220,4.35,28,2,2,2,2,36,4.444444444444445
eHpf-vadyWIK23bdK67IXA,Dolo,41.852565,-87.636045,2,54,47,14,8,10,133,3.954887218045113,6,2,0,0,1,9,4.333333333333333
xx4AqXy2x2jvIIR2hsQotQ,Hash,41.906551,-87.686734,2,79,47,32,22,12,192,3.828125,11,3,1,1,3,19,3.9473684210526314
CJKbHl_jPTtzMIQYTHHgiA,Ceres’ Table,41.938555,-87.6443808,2,65,36,18,21,12,152,3.7960526315789473,3,1,3,1,1,9,3.4444444444444446
fUYB5sY0lSx_xFL9pNmh1A,Snack Planet,41.8550594,-87.6320696,1,10,2,0,0,0,12,4.833333333333333,2,0,0,0,0,2,5.0
3K8whWvhWypsf44WU1yBjw,El Milagro Tortilleria,41.844866,-87.702186,1,65,38,9,5,8,125,4.176,11,8,0,3,3,25,3.84
YF1YUnp1hDs38O5khC6rjQ,Cafe Central,41.8960102,-87.6639254,1,71,70,19,6,6,172,4.127906976744186,14,5,1,0,1,21,4.476190476190476
Kav5AnP2BV4FVkU0D8LuWA,The Winchester,41.899786,-87.67558,2,63,51,29,27,10,180,3.7222222222222223,3,1,1,5,3,13,2.6923076923076925
9SY1qjFBIo8W48W6OTGWGg,Batter & Berries,41.9316821,-87.6577734,2,576,273,109,84,74,1116,4.068996415770609,69,23,15,17,19,143,3.7412587412587412
sKyAnMdp323a5rliCqRvHQ,Belly Shack,41.9161563,-87.6875879,2,233,312,138,84,21,788,3.8274111675126905,21,31,9,8,1,70,3.9
uE8QnPNXFgKXgF9FVcRQeA,Grandview Tavern & Beer Garden,41.8912849,-87.6576396,2,38,21,7,7,6,79,3.9873417721518987,14,4,1,0,0,19,4.684210526315789
ID-0tVdM9YatcHzjDfiofg,Fremont Chicago,41.890639,-87.628707,3,23,2,2,1,2,30,4.433333333333334,2,1,0,0,0,3,4.666666666666667
YQNUIt5GsgreY3jVGjAttw,Mexique,41.9013087,-87.6827676,3,254,212,70,32,12,580,4.144827586206897,27,18,5,4,1,55,4.2
wzw3aysUi9sBq-wLb6OXbQ,Zizi’s Cafe,41.9333056,-87.6536617,2,249,79,26,16,9,379,4.432717678100264,39,6,1,2,1,49,4.63265306122449
37g7wVs9Wi1QtX9lBXogoQ,Cantina 1910,41.973238,-87.667674,3,68,56,34,49,29,236,3.360169491525424,38,6,0,5,9,58,4.017241379310345
c3DGLqz31UbLapOYoRJJiw,Asian Outpost,41.8653813,-87.6254853,2,83,70,19,13,8,193,4.072538860103627,11,6,1,0,1,19,4.368421052631579
BmqLmgX7i-pM-0h_xzbwMA,Maude’s Liquor Bar,41.884617503513,-87.649123464731,3,323,293,68,30,26,740,4.158108108108108,51,17,5,3,33,109,3.458715596330275
d8sfksDhA_dfc6AXgeOv2A,Appellation,41.976669,-87.668761,2,11,6,3,0,2,22,4.090909090909091,0,0,0,0,0,0,x
D1K-vLXfA5-hppRzVY7q2w,Smoke Daddy,41.9034702,-87.6726919,2,228,380,173,92,50,923,3.697724810400867,54,29,14,9,14,120,3.8333333333333335
xHdy8fbDVB4Nb_WGBN50Ow,Humboldt Haus Sandwich Bar,41.9102569,-87.7012481,1,31,12,2,1,1,47,4.51063829787234,8,5,0,0,0,13,4.615384615384615
yeS75b3f-Q7pDFWB83x8bg,LYFE Kitchen,41.9097155,-87.6478812,1,7,3,0,1,1,12,4.166666666666667,1,0,0,0,0,1,5.0
LPZP6SvCfBIAQahXDx3Ajg,Turquoise Restaurant,41.942897,-87.682599,2,163,175,71,39,25,473,3.8710359408033828,33,30,3,5,11,82,3.841463414634146
KNTr01EKcdjQCrTyJVsMaA,Marshfield’s Urban Grill,41.925815,-87.669692,2,35,12,2,0,4,53,4.39622641509434,6,2,1,2,0,11,4.090909090909091
tntGxmQJyv8ZomQJ5Z14BQ,Frasca,41.9431399,-87.6713934,2,158,264,90,36,13,561,3.9233511586452763,23,17,2,5,6,53,3.8679245283018866
iBA2L7fbTJi2PcrjDaOfoQ,Sammy’s Kitchen,41.7928550561618,-87.7613519132137,1,61,25,0,1,1,88,4.636363636363637,8,2,0,0,0,10,4.8
al530TnimkgqmPU6q-2hQw,Tiztal Café,41.9662128,-87.6666323,2,171,174,34,12,6,397,4.239294710327456,16,7,1,0,1,25,4.48
hyQUASRVWrEL3Qlob3nWGQ,Taketei,41.9781553,-87.6583534,2,53,21,1,3,3,81,4.45679012345679,11,1,0,0,0,12,4.916666666666667
6cYzBl8YfgNUv2oMaijrGQ,Jim’s Original Hot Dog,41.8657297,-87.6452289,1,210,124,38,14,11,397,4.279596977329975,31,8,3,1,3,46,4.369565217391305
rgaoVm01HFYC292weFuTXA,Goosefoot,41.9686988,-87.6959545,4,135,42,16,2,2,197,4.553299492385787,27,1,3,0,1,32,4.65625
LbW8aM6FHUE5-AKcY-5dYg,Delux Bar & Grill,41.89398,-87.651408,2,42,72,26,9,5,154,3.8896103896103895,13,8,1,0,2,24,4.25
ay8t2gsoi-DznQDv0kZh2w,Little Saigon Baguette,41.9772529,-87.6598873,1,26,3,0,0,1,30,4.766666666666667,5,1,0,0,1,7,4.285714285714286
GYc8FyG3_BZPMA_2ji3a1A,Rapidito,41.9322175499411,-87.675347328836,1,26,9,1,2,0,38,4.552631578947368,8,1,0,0,1,10,4.5
fW5mNILkfD3-0cOqoPsRvA,Labriola Chicago: La Stanza Ristorante and Labriola Cafe,41.892014,-87.623597,2,56,43,14,9,9,131,3.9770992366412212,7,2,1,3,0,13,4.0
D0mt_bc3x6uIT7HoH3UMsg,Armitage Courtyard Cafe,41.9168994,-87.7336071,1,9,1,0,1,0,11,4.636363636363637,2,0,1,0,0,3,4.333333333333333
NTQlPwOGbQhwbbjkUBoPuw,Fulton Market Kitchen,41.887184,-87.650678,3,79,44,34,21,18,196,3.739795918367347,14,7,2,0,10,33,3.4545454545454546
Kj3D8EB8_H7_gOFhM96AMQ,Patsy’s Place,41.9333233,-87.6593779,2,72,53,12,11,5,153,4.150326797385621,9,2,1,2,1,15,4.066666666666666
m_J7wFRwwRdck6M-dfn3iw,Buena Vista,41.9389873,-87.6443554,1,82,90,28,15,6,221,4.027149321266968,10,9,1,0,2,22,4.136363636363637
PidZ26sboIS3-6CtUpNskA,Chicago Raw,41.8841694251783,-87.6408842460633,2,113,44,12,6,2,177,4.468926553672317,26,6,0,2,2,36,4.444444444444445
mGnNer7raiilgF0JWCpGtw,The Office,41.8865541,-87.6520562,4,100,25,8,5,5,143,4.468531468531468,10,3,0,0,1,14,4.5
oEFJ29zAQaCNnQzebHQvpg,The Violet Hour,41.9089221,-87.6777565,3,845,538,179,95,71,1728,4.152199074074074,88,45,14,5,51,203,3.561576354679803
cgeDgR3PmctNyv-P4iH-3w,Balena,41.9120291,-87.6481094,3,242,226,93,46,14,621,4.024154589371981,21,11,4,7,3,46,3.869565217391304
EDLESuetqE5RZN7kP8vI9g,Puesto Sandwich Stand,41.9431996,-87.6539909,1,42,3,2,0,1,48,4.770833333333333,4,0,0,0,0,4,5.0
S82Ug9CXLF-mFAi6n33UEA,G & O,41.8909068,-87.6588588,2,54,35,3,10,1,103,4.271844660194175,4,3,1,0,0,8,4.375
o54U2VkQama8FI30qDkWvw,The Chicago Diner,41.9440076,-87.6491442,2,712,478,171,90,48,1499,4.1447631754503,115,76,18,9,14,232,4.1594827586206895
tW2jfL-qMccAYZSghPBbHA,The Art of Pizza,41.9370799,-87.668161,1,409,284,119,56,44,912,4.050438596491228,79,46,11,10,35,181,3.685082872928177
hrIjVmrXhOHha_qeip4u4w,The Silver Palm,41.8955861,-87.6548113,2,51,107,50,23,13,244,3.6557377049180326,6,9,1,3,5,24,3.3333333333333335
8hioSQ9DWbtChDWRS_RglQ,Gideon Welles,41.9633249818403,-87.6853008940816,2,24,9,6,6,1,46,4.065217391304348,2,0,0,0,1,3,3.6666666666666665
jQKdqHbV1MhivawvvA24dQ,Jerk Modern Jamaican Grill,41.8963802,-87.6482277,2,60,36,22,22,21,161,3.5714285714285716,5,0,0,3,3,11,3.090909090909091
-LJayGlySYnQ8z2VvZyFNw,Little Vietnam,41.9837803,-87.6593784,1,90,43,19,4,2,158,4.360759493670886,11,5,2,0,1,19,4.315789473684211
ZZTbDVRmMaXmPKNGTCpWUw,Ameer Kabob,41.9008173,-87.6629636,1,57,58,19,12,13,159,3.842767295597484,13,8,2,0,5,28,3.857142857142857
Jg37rNs7b3G0R5ZGg9Z7rQ,Izakaya Mita,41.917633,-87.677923,2,48,16,12,5,7,88,4.056818181818182,2,0,0,0,0,2,5.0
jDSPb0n9xo--C6qpbkEz-A,Yefseis Cafe,41.943147,-87.649694,1,77,29,11,5,3,125,4.376,21,2,4,1,0,28,4.535714285714286
Psi34XLTOtVqLYS9StO1hA,Tweet,41.9739742,-87.655207,2,569,360,109,67,56,1161,4.1360895779500435,49,27,9,9,11,105,3.895238095238095
ASlx7L6iRPTwgzutJYNjxQ,Dinosaur Bar-B-Que,41.909549,-87.652034,2,59,62,39,35,8,203,3.6354679802955663,4,0,0,1,9,14,2.2142857142857144
pdEujVnzjHNIX99o2JRgqw,Joe Boston’s Italian Beef,41.8957788,-87.700639,1,57,39,23,10,4,133,4.015037593984962,17,4,1,2,3,27,4.111111111111111
gmwPUKf6fL2QNRlt3t1zIQ,R Public House,42.016348,-87.66857,2,36,21,11,9,3,80,3.975,5,2,1,0,3,11,3.5454545454545454
1cgWXsikJqAQezRmruj2rg,Bistro Campagne,41.9636449,-87.685632,3,269,177,53,35,11,545,4.207339449541284,43,19,5,3,4,74,4.27027027027027
bWmcUf2Ev0U-vuaolEU3cQ,Bricks,41.9169064,-87.6365454,2,157,182,46,25,23,433,3.9815242494226326,20,11,5,3,5,44,3.8636363636363638
UQ3cGi3GdBljE3i2_qLcBQ,Artopolis,41.877626,-87.647589,2,228,284,71,22,24,629,4.0651828298887125,35,29,6,4,6,80,4.0375
PlJM2cGFBEhv51_ZpP2EuQ,Giordano’s,41.891432,-87.6090801,2,21,12,7,3,2,45,4.044444444444444,2,0,2,1,1,6,3.1666666666666665
-pgwH-_0OaF4SAGeqAJTig,Same Day Cafe,41.9299165,-87.7071654,2,36,10,3,1,0,50,4.62,1,0,0,0,0,1,5.0
sWYRaPCYHrTxsZPLWmzkzQ,Scofflaw,41.9173240661621,-87.7071762084961,2,269,159,43,26,13,510,4.264705882352941,18,11,3,12,18,62,2.9838709677419355
HwOzFKTCkOE1NwGrxXxuAQ,Rickshaw Republic,41.9238966,-87.647072,2,109,67,28,18,12,234,4.038461538461538,12,3,3,1,1,20,4.2
763ARZeDvQfhXZvkDlKtFw,DMK Burger Bar,41.936082,-87.654331,2,561,582,256,138,42,1579,3.9385687143761876,90,80,21,22,13,226,3.938053097345133
kLxobgGBwgdjz3jGjWGorg,L’Appetito,41.894957420707,-87.626742636595,1,63,72,20,9,3,167,4.095808383233533,5,4,2,0,0,11,4.2727272727272725
J8omlM4n4HBsgR7nVtAgqQ,GreenRiver,41.8937834,-87.6207793,2,44,25,2,6,3,80,4.2625,4,0,0,2,0,6,4.0
cBe4_QnP73qdxNnld4boTw,Xoco,41.9087869,-87.674446,2,67,64,46,44,15,236,3.5254237288135593,10,3,1,3,3,20,3.7
lFuxZf4-nCThJd8fV_EwBw,Paddy Long’s,41.932871,-87.655042,2,106,138,38,21,19,322,3.9037267080745344,23,3,4,1,4,35,4.142857142857143
ZGnxEJXlv8e41qhVLkfKtQ,Acadia,41.85904,-87.6252412,4,151,72,35,17,15,290,4.127586206896551,24,5,0,7,11,47,3.5106382978723403
98XplJ-Nj_VpzpJWDXpHtg,Don Fresco,41.874314084668,-87.6405603971736,1,13,4,1,1,1,20,4.35,1,0,0,1,0,2,3.5
r732n4Oq1YO02K58fcR-Yg,Sushi Dokku,41.8841737,-87.6484729,2,80,73,26,17,8,204,3.980392156862745,11,2,0,1,2,16,4.1875
J9WfLOHSTcXaT_9kz2gq0Q,Conte Di Savoia European Specialties,41.8695576,-87.6632396,1,84,68,17,3,0,172,4.354651162790698,15,3,1,2,0,21,4.476190476190476
mPFMi734NXkvLFotygLrCA,Sepia,41.883933,-87.6424,3,235,299,171,65,29,799,3.8085106382978724,44,26,7,12,32,121,3.3140495867768593
-GBWUeysCXIZ_0Fb5YoVOQ,DMK Burger Bar,41.8911749991999,-87.6070650697097,2,8,5,1,1,0,15,4.333333333333333,0,0,0,0,0,0,x
sR4EOfPuI-at41uIxIZPhw,Hopleaf,41.9758081,-87.6686192,2,729,611,202,98,63,1703,4.083382266588374,101,57,21,20,23,222,3.869369369369369
nXbaIvOAi14TcQhKE2k_5A,El Taco Feliz Taqueria,41.9458009,-87.7633956,1,40,10,1,2,2,55,4.527272727272727,10,0,0,1,0,11,4.7272727272727275
hiJMiKoyP24G-0oILI8d3w,Tavern at the Park,41.8849173,-87.6231249,2,116,168,116,59,32,491,3.564154786150713,13,21,7,6,9,56,3.4107142857142856
HR4SEi49-WxKZe6Bht6XdQ,Fuh,41.9223116,-87.6446112,1,83,35,18,7,0,143,4.356643356643357,3,2,0,0,0,5,4.6
RcmyqKQeG5gceCrGW237Ig,LYFE Kitchen,41.8936116473435,-87.6204406772432,2,40,21,18,2,1,82,4.182926829268292,8,1,1,0,0,10,4.7
0FonNwb6KPN-AwkC_yHQ4Q,Tamale Spaceship,41.9062012,-87.6771505,1,101,70,23,7,6,207,4.222222222222222,12,2,0,1,1,16,4.4375
ZMAU6cSfat7mzamWGm7Dlw,Old Fifth,41.8814233,-87.653299,2,72,60,31,18,13,194,3.8247422680412373,20,5,3,2,3,33,4.121212121212121
i4qb--5htPb1OOhFBmT9_A,Co Co Vietnamese Sandwiches & Pho,41.9686496203165,-87.6702262007485,1,28,12,5,1,0,46,4.456521739130435,1,0,0,0,0,1,5.0
UylJ0EgGLxJO2E-rsf2naA,La Plena Restaurant,41.9026756,-87.6926869,2,42,24,5,2,4,77,4.2727272727272725,7,3,1,0,2,13,4.0
VcXMOBv7brvPwL9j1cd_Gw,Cafe Orient 33,41.9689321,-87.7084639,1,101,16,9,1,2,129,4.651162790697675,11,0,0,1,0,12,4.75
BjZ1dWcQOt7w7BsMszxKHA,UB Dogs,41.885406019773,-87.635216774701,1,170,90,8,5,2,275,4.530909090909091,24,0,1,2,1,28,4.571428571428571
Z2nOMPedr7XYhgYhILJjEA,Piece Brewery and Pizzeria,41.9104318,-87.6761383,2,1059,1294,437,154,82,3026,4.022471910112359,240,190,61,29,81,601,3.7970049916805326
_b69OdBNLhysN1jFlYNQiA,The Bongo Room,41.908417,-87.674926,2,491,434,160,87,65,1237,3.96928051738076,48,31,17,15,16,127,3.62992125984252
UTGDlrcdYWUwQYzXUChdaA,Machu Picchu Restaurant,41.9523523,-87.6691891,2,95,156,66,23,22,362,3.770718232044199,18,7,1,2,5,33,3.9393939393939394
wUkLiVC0XDuRs9zihWUPTw,Mike Ditkas,41.8985011,-87.6255777,3,250,219,79,43,24,615,4.021138211382114,37,24,9,9,7,86,3.872093023255814
7KyqEe52uLbZpzS7TJBKIQ,Andorka’s Sandwich Shop,41.8537462,-87.6467556,1,19,6,0,0,3,28,4.357142857142857,3,0,0,0,0,3,5.0
1W3Ybn4d4GVQVulq-m7Xeg,Briciola,41.8986208,-87.6771031,2,125,74,25,18,11,253,4.122529644268774,14,3,2,1,2,22,4.181818181818182
7BRb9kA1cXQ17FQoebc-Nw,Wicker Basket Cafe,41.9029,-87.680332,1,38,36,9,5,6,94,4.01063829787234,6,4,1,0,0,11,4.454545454545454
ufxKkcPhjlF4x2C1Or8ckA,Lowcountry,41.9428932,-87.6528702,2,87,19,4,1,3,114,4.631578947368421,4,0,0,0,0,4,5.0
_IFYKbyisxTsDiuqKolI4A,Pittsfield Cafe,41.883263,-87.62597,1,88,123,45,21,17,294,3.8299319727891157,16,2,0,2,0,20,4.6
Ww6KfdQSMbrmzEhKIK48UA,Turbo Tacos,41.918518,-87.6905424,1,20,5,2,0,2,29,4.413793103448276,2,0,0,0,0,2,5.0
gFQ-NcVxqAb4S29S7DLehA,Hot Dog Station,41.9679886090324,-87.7134617808249,1,76,24,3,0,1,104,4.673076923076923,22,3,1,1,2,29,4.448275862068965
WA8Fuuv9zRfZ8H8YkeYxsg,Aloha Eats,41.9287291,-87.6425673,1,243,301,117,51,25,737,3.9308005427408412,33,25,7,3,5,73,4.068493150684931
zQnbP2dJoro12dk66RUXBA,Blackwood BBQ,41.8856588571597,-87.6360799825096,1,90,97,33,10,0,230,4.160869565217391,13,8,0,1,1,23,4.3478260869565215
6Uvu_3H40Myo7v4CsPKZaw,Mixteco Grill,41.961436782471,-87.669483212404,2,213,240,86,56,15,610,3.9508196721311477,30,31,14,13,9,97,3.618556701030928
FMoNA-t4uxss2JA37ZNEJg,High Five Ramen,41.883651,-87.648968,2,104,93,56,29,12,294,3.8435374149659864,5,1,0,2,1,9,3.7777777777777777
eqEGyRFlm7nixQ4-cNoslg,más,41.8831722,-87.6474028,2,80,60,31,16,11,198,3.919191919191919,19,12,1,1,3,36,4.194444444444445
hgE7M0H_iY4wIzFAgrOTCA,Saucy Porka,41.8767417,-87.6331859,1,233,129,27,4,2,395,4.4860759493670885,9,19,3,6,3,40,3.625
TeJGJA4_iPNMDuQUxmphHg,Catch 35,41.886448,-87.629102,3,172,229,97,46,20,564,3.8634751773049647,24,22,7,4,6,63,3.857142857142857
e1UpMPNUdB0rnmsz3z2YHw,Flo,41.934354,-87.6680679,2,12,1,2,3,1,19,4.052631578947368,0,0,0,0,0,0,x
J-i3frdwkM0prRxH98Zp2Q,Native Foods Cafe,41.878867,-87.631168,2,265,149,38,26,16,494,4.257085020242915,32,16,15,6,9,78,3.717948717948718
bOSkNVWF5ByzJlKzaLx75Q,Bodhi Thai,41.857488,-87.6420382,2,42,11,7,2,0,62,4.5,7,2,0,0,0,9,4.777777777777778
nikHMPArO0qCbfW5txuohA,Curry Point,41.9531407,-87.6543253,2,55,29,5,8,11,108,4.0092592592592595,5,1,0,0,1,7,4.285714285714286
TxbSPkwNpy0HVXcq2sRirw,Da Lobsta,41.8898095,-87.6312638,2,78,35,15,19,8,155,4.006451612903226,10,4,1,0,1,16,4.375
xTu2kHPjSHKvyQNos6E1qw,Blowfish Contemporary Sushi,41.9834523,-87.6591499,2,67,16,4,3,2,92,4.554347826086956,3,0,0,0,0,3,5.0
3ZM20Dzkfj7rhFE9aPU3Tw,Drew’s on Halsted,41.9403396556238,-87.6491832733154,2,83,122,38,30,20,293,3.744027303754266,21,12,6,4,7,50,3.72
h-CNRJ-bqSZvz75J4A9cFg,Wilde Bar & Restaurant,41.938693345893,-87.644454650351,2,183,372,156,71,26,808,3.761138613861386,38,45,11,9,15,118,3.694915254237288
3Mg9lJsKeQSVd7rEx8LMtg,Grange Hall Burger Bar,41.8846294316723,-87.6492026556238,2,184,221,81,38,25,549,3.912568306010929,24,10,2,9,6,51,3.7254901960784315
uVYkk8dsnSMSd6xMGGoGTw,Fat Rice,41.9319254,-87.7022888,2,170,119,82,47,18,436,3.8623853211009176,23,9,5,5,4,46,3.9130434782608696
6dLOMMcJSany2-DUErsUOw,"Smalls, Smoke Shack & More",41.9542307,-87.7054438,2,147,52,19,7,5,230,4.430434782608696,12,5,2,0,1,20,4.35
alA4ccSsga38IVqkZyRk6g,Rolls ‘N Bowls,41.9815232,-87.692516,2,139,84,17,23,12,275,4.1454545454545455,32,10,3,2,2,49,4.387755102040816
pOQOEBZbKXA3MLUXWsSyTg,Beezzee,41.9330308,-87.6535745,1,109,39,10,5,3,166,4.481927710843373,26,2,1,0,0,29,4.862068965517241
wojOJ7lqmBbI6J0dv-TUDQ,Sono Wood Fired,41.9103515,-87.6488327,2,90,70,25,10,1,196,4.214285714285714,6,6,3,1,3,19,3.5789473684210527
vOEqVTBwUek7-jKrN1Th8g,Chicago Bagel Authority,41.9178624,-87.6529861,1,197,192,65,46,43,543,3.8360957642725597,31,18,4,3,11,67,3.8208955223880596
3_bJTUh5BNaD10s4hZUcjQ,Patino’s Grill,41.953712,-87.702385,1,38,7,0,0,0,45,4.844444444444444,5,1,0,0,0,6,4.833333333333333
UmiTS3y5Jj2beRZjtVQ89Q,Presidio,41.9136825,-87.6774595913994,3,37,23,8,10,2,80,4.0375,7,2,2,0,1,12,4.166666666666667
gsoGvhrnB_-UmsYmNlXxpQ,O’Cha Thai Cuisine,41.9195335,-87.6778243,2,62,37,17,10,5,131,4.076335877862595,16,7,0,0,0,23,4.695652173913044
ywsJZpVHphgcbfbDERiceQ,Chicago’s Pita Grill,41.93653,-87.7660779,1,46,23,7,9,10,95,3.905263157894737,8,2,0,0,0,10,4.8
8KzVXx6GCNBZBdtRGIdZDA,Sable,41.8909325662424,-87.628073341217,3,386,408,142,72,53,1061,3.944392082940622,40,30,4,14,36,124,3.193548387096774
sNhKEb8iKvN4MDxpOiHFWg,D’amato’s Bakery,41.9013087,-87.6827676,1,139,68,16,8,4,235,4.404255319148936,24,9,2,3,3,41,4.170731707317073
TC8tG6To87DUzC365njvXw,River Roast,41.8879001147819,-87.6322498172522,2,130,96,50,23,13,312,3.983974358974359,20,11,2,1,2,36,4.277777777777778
1BLEz3cD4DHcAxlTu_Yb4g,Allende Restaurant,41.9257261,-87.6491677,1,112,95,29,15,15,266,4.030075187969925,24,15,2,2,3,46,4.195652173913044
wt-j8BaVzOd3pNN7swvLgA,Rose Angelis,41.9289828,-87.6617149,2,256,188,43,42,31,560,4.064285714285714,53,11,4,8,9,85,4.070588235294117
xo3zcBRNkPFnHCy1UvkrGw,HQ Howard Quintero,41.956225,-87.708428,2,74,16,3,1,0,94,4.73404255319149,7,2,0,0,0,9,4.777777777777778
80k87CEiJTEHTZ4oHiQ6QA,Podhalanka,41.9031971642231,-87.6670556213551,2,127,111,33,14,13,298,4.090604026845638,19,4,1,3,5,32,3.90625
c1UpBs334fvFYFP-tzmhnw,The Warehouse Bar & Pizzeria Chicago,41.924935,-87.664113,2,28,3,4,1,3,39,4.333333333333333,1,0,0,0,0,1,5.0
VCLQpc78prtGTxJAKjz-Ow,First Draft,41.873437,-87.630308,2,117,75,23,11,7,233,4.218884120171674,12,7,2,1,4,26,3.8461538461538463
C9zXJ484qD6K8o0ISOQI7w,North Pond,41.9298809,-87.6373917,4,180,104,35,40,22,381,3.9973753280839897,17,11,8,6,7,49,3.510204081632653
Jdk9wGnFs_lp9rndHnAOPg,Murphy’s Red Hots,41.9396292,-87.6595379,1,103,60,21,4,3,191,4.340314136125654,21,6,1,1,2,31,4.387096774193548
Sy8ZjqYOE62tnpf0b1qa1g,Gale Street Inn,41.9699747728431,-87.762835174799,2,203,139,36,32,16,426,4.129107981220657,46,13,5,8,8,80,4.0125
2R7ipjEkeQo821P9AnpJGA,Enso Sushi & Bar,41.9109567,-87.6771127,2,98,88,39,14,10,249,4.004016064257028,11,7,0,3,1,22,4.090909090909091
SbdZRJSSISB-cUQ9ShBetQ,Corridor Brewery & Provisions,41.94474,-87.664295,2,23,33,11,8,2,77,3.8701298701298703,4,0,0,0,2,6,3.6666666666666665
27cckuU8ONgwWKxf7fUW3g,Kitchen 17,41.9390896,-87.644882,2,112,31,5,5,8,161,4.453416149068323,28,4,0,0,9,41,4.024390243902439
85GOeDztnzCAWhjKSl7Dvw,Local Root,41.8931004702588,-87.6175828539673,2,90,83,48,42,18,281,3.6583629893238436,27,6,4,5,5,47,3.9574468085106385
CTChDf-Zr4R9QuWpKtfEzQ,Kitchen Sink,41.978083720211,-87.658256870461,1,62,56,17,9,4,148,4.101351351351352,7,5,5,1,3,21,3.5714285714285716
LNeYZDuQbpCX0iL1novUYQ,Be Leaf,41.8829355,-87.6365332,2,33,17,10,0,5,65,4.123076923076923,11,0,0,0,1,12,4.666666666666667
Kc6TY-tutgziYmJJWtVTVw,Tete Charcuterie,41.8843851,-87.6550776,3,67,34,17,10,12,140,3.9571428571428573,2,5,0,1,1,9,3.6666666666666665
j7kcbdUFjroGeta8ieN1gw,Perkolator,41.953164,-87.7781381,1,58,13,3,2,1,77,4.623376623376624,10,1,0,0,0,11,4.909090909090909
zN8zvLiGGiTGNDqDaRWp_Q,Fahlstrom’s Fresh Fish Market,41.9399961,-87.6611532,2,98,49,15,19,15,196,4.0,12,4,0,2,4,22,3.8181818181818183
yBRaSkuYwFhYEoucDyD0lA,Lao Sze Chuan,41.8532889,-87.63495,2,270,376,161,120,137,1064,3.4906015037593985,53,27,15,15,78,188,2.797872340425532
dFGvSIzHZRwABSZYZSYpcg,Buzz Bait Taqueria,41.9099865,-87.6344183,2,26,21,14,2,5,68,3.8970588235294117,4,1,0,0,2,7,3.7142857142857144
-ZFTAEd0RPA-e8WfAOglyQ,Birreria Reyes de Ocotlan,41.858088,-87.659808,1,35,31,1,3,2,72,4.305555555555555,8,6,1,0,1,16,4.25
taKKA87TcYh2ewg-_N-qXg,Dak,41.9946904,-87.6587321,2,124,114,22,11,6,277,4.223826714801444,19,7,1,0,2,29,4.413793103448276
R5GAPWJ1CI-4gJzdJ0dxbg,Inspiration Kitchens,41.9678138,-87.6544689,1,238,131,32,9,4,414,4.42512077294686,30,9,1,0,1,41,4.634146341463414
_UJ3KqtHIHjExbAg-iIGUA,Greek Islands Restaurant,41.878967,-87.647631,2,420,483,149,79,45,1176,3.9812925170068025,92,49,11,10,56,218,3.5091743119266057
Z5xaAmM_cHIHv8NxVXXsCg,The Boiler Room,41.922116,-87.697669,2,177,265,113,63,48,666,3.690690690690691,31,24,8,13,32,108,3.0833333333333335
_TtHwwgv7qjzxBvBlJPUow,The Southern,41.9107086,-87.6742294,2,167,261,158,82,46,714,3.589635854341737,29,20,5,17,15,86,3.36046511627907
OO-PuBnfrdXlZWKCyPPiQg,Kim & Carlo’s Hot Dog Stand,41.8653123213288,-87.6154239848256,1,87,37,14,8,1,147,4.36734693877551,18,4,0,0,1,23,4.6521739130434785
NlrQZMJlMoC6gY9jb5zOQw,Merla’s Kitchen,41.9761135,-87.7134197,1,40,30,4,5,1,80,4.2875,6,1,0,2,3,12,3.4166666666666665
34FOiHFyfGECttI8P2al7A,Grace,41.8847821,-87.6449338,4,132,31,17,8,1,189,4.507936507936508,19,3,3,4,0,29,4.275862068965517
HcdXUshp63g1LEyRakukdw,Riccardo Enoteca,41.9206237792969,-87.6378326416016,2,20,30,5,8,1,64,3.9375,4,2,0,1,2,9,3.5555555555555554
mspxW1oelEoo6YJskI5cJg,Burger Bar Chicago - South Loop,41.8684118,-87.6242009,2,54,45,17,11,10,137,3.8905109489051095,3,2,1,0,7,13,2.5384615384615383
AqJM4ZZqKnYU5z4E8DruhA,Happy Camper,41.9042336,-87.6343073,2,37,17,12,6,1,73,4.136986301369863,10,0,1,0,0,11,4.818181818181818
8QTZlr-QjG6yzeP2eCVKEQ,JINYA Ramen Bar,41.9325725,-87.6432534,2,67,70,24,22,6,189,3.8994708994708995,6,2,0,1,1,10,4.1
BwoMqO_x_FRT949HOAtCEw,Chi Cafe,41.853511,-87.634486,1,237,281,113,35,28,694,3.956772334293948,15,34,13,3,13,78,3.448717948717949
ARSH7elrKMtULqiPX6PvuQ,Blue Frog’s Local 22,41.8902364,-87.6271479,2,44,53,18,12,9,136,3.8161764705882355,11,4,3,2,2,22,3.909090909090909
jXFtE49rqbJyHuyc8DZuzA,LD Pho,41.9673712,-87.7084619,2,47,8,1,1,1,58,4.706896551724138,3,0,0,1,2,6,3.1666666666666665
I5sSX3kNw8SN5kjB1Yc4UQ,Native Foods Cafe,41.908664,-87.6753109,2,198,158,49,41,19,465,4.021505376344086,26,16,4,1,5,52,4.096153846153846
9MiP2wtclPG5EljSVJHo4g,Dawali Mediterranean Kitchen,41.911707,-87.647938,2,197,134,34,16,8,389,4.275064267352185,26,6,1,1,1,35,4.571428571428571
UBRWllRUeY1yolEfcglRmA,Macello,41.885228,-87.6582169,2,83,71,31,10,13,208,3.9663461538461537,22,13,5,2,4,46,4.021739130434782
T_egMuf7xJHLdldzPqOaSQ,Qing Xiang Yuan Dumplings,41.8550594,-87.6320696,1,60,26,10,2,4,102,4.333333333333333,7,1,1,1,1,11,4.090909090909091
DJEyjd7_tm0jPjuj2gnDPg,Bar Pastoral,41.9363021850586,-87.6441345214844,2,34,23,7,4,7,75,3.973333333333333,3,0,0,0,0,3,5.0
Vs0fNsYWdZQGOQ960-lbfQ,Grandma J’s Local Kitchen,41.9093755885252,-87.7071511745453,2,121,45,16,14,10,206,4.228155339805825,13,3,1,2,1,20,4.25
NE4Mg03d8KryJ7_u4RaPSQ,Beard & Belly,41.9544703,-87.6697232,2,6,0,0,0,1,7,4.428571428571429,3,0,0,0,0,3,5.0
WODBuNjlEgNIf459Wh-AWw,Gather,41.964348,-87.685367,2,255,91,27,15,8,396,4.4393939393939394,38,8,3,2,2,53,4.471698113207547
Q9uxInveq-RFvpF1jkO8wQ,Band of Bohemia,41.9674141,-87.6751169,3,36,10,4,7,2,59,4.203389830508475,3,2,0,0,0,5,4.6
txerhr0c6RtWhlNWhWIB5Q,Tac Quick,41.953605,-87.6548051,2,151,152,51,29,29,412,3.8907766990291264,12,11,4,3,7,37,3.4864864864864864
2o05wVsH30snEgif81RgXg,La Pane,41.9540244,-87.7025206,1,45,22,6,3,1,77,4.3896103896103895,14,2,1,0,2,19,4.368421052631579
JCmp_Uf0S2cnGQtDvsbleg,Luella’s Southern Kitchen,41.9652587902013,-87.686160877347,2,121,59,19,20,13,232,4.099137931034483,17,4,1,1,1,24,4.458333333333333
F7SE2NPZLwolMCzt3qXzzQ,Si-Pie Pizzeria,41.9453333258613,-87.6459314569375,1,120,15,1,6,10,152,4.506578947368421,32,1,1,0,2,36,4.694444444444445
pZ2mWLXfc0UPojcDkTsLaw,Q-BBQ,41.932896,-87.6472172,2,87,78,36,23,15,239,3.8326359832635983,8,6,6,6,1,27,3.5185185185185186
QNbWTNuAEMWOurHN8rMXnA,Chicago Pizza And Oven Grinder Company,41.9208205,-87.6372441,2,522,353,158,73,40,1146,4.0855148342059335,101,36,11,12,35,195,3.8
ecFp44Y6EGdgtmZ-jPqaYA,Pi-Hi Cafe,41.9460656925374,-87.6877528213354,1,171,22,4,8,3,208,4.6826923076923075,24,3,0,0,0,27,4.888888888888889
DOL1NGAw_4xfsiA2PBMq9g,Pump Room,41.905941,-87.628357,3,179,223,84,69,31,586,3.7679180887372015,26,17,9,10,22,84,3.1785714285714284
xrMepV3KUqltASF8VzKE-A,The Glunz Tavern,41.9040365,-87.6347493,2,36,23,5,9,1,74,4.135135135135135,5,2,0,0,0,7,4.714285714285714
oQ9lPfLOw4JweiAvg-8Gxg,Hash House a Go Go,41.9043895,-87.6288947,2,150,180,90,84,47,551,3.5480943738656987,18,13,6,12,19,68,2.985294117647059
WpiOkhWb2hWxIbS3ivl6Pw,Azul 18,41.8579513,-87.6578871,2,40,28,5,3,3,79,4.253164556962025,2,1,0,1,0,4,4.0
IgiFxgUFR9BDnQ9PeGHaEA,Crosby’s Kitchen,41.9450943,-87.6636925,2,136,168,58,29,8,399,3.989974937343358,12,8,2,2,9,33,3.3636363636363638
66-K1gf6ToEqd_jo5iUvPA,Opart Thai House,41.8560821,-87.6274846,2,214,247,80,37,32,610,3.940983606557377,31,27,7,4,32,101,3.207920792079208
JqYRQUWF7gINp2MugU8Avw,Taqueria Tayahua,41.848023,-87.68516,1,21,5,1,1,1,29,4.517241379310345,4,1,0,0,1,6,4.166666666666667
0KTDs4anWhAwa_05ixUAIQ,Feast,41.911148,-87.677722,2,145,308,175,85,53,766,3.531331592689295,17,26,11,14,16,84,3.1666666666666665
cxAkuwv7p4gm4Coixw7h9A,Lou Malnati’s Pizzeria,41.871487,-87.6273372,2,441,441,202,83,41,1208,3.9586092715231787,66,45,18,10,117,256,2.73828125
y0B-AArugfrUai3eEG8_3A,Taqueria Moran,41.9225071,-87.697476,1,128,147,32,17,12,336,4.0773809523809526,22,12,0,2,4,40,4.15
5wZyq2ZuYHIsDxWv16njJg,Pizza House 1647,41.915826,-87.669633,2,59,21,6,15,7,108,4.018518518518518,16,3,0,2,2,23,4.260869565217392
6hw-HPdP1oDpCbMHBLid-w,Taste of Lebanon Restaurant,41.9760037,-87.6687246,1,303,126,31,10,4,474,4.506329113924051,38,9,3,0,3,53,4.490566037735849
7mCeefskNUtOkzxt_MLHKA,The 3rd Coast,41.9056506,-87.6303378,2,157,178,58,17,6,416,4.112980769230769,57,23,1,4,3,88,4.443181818181818
Qvqhbg_EWM9uXToN3UxHQA,Mary’s Taqueria,41.8566099,-87.642026,1,38,19,4,2,1,64,4.421875,4,1,0,0,0,5,4.8
YF_UAlKxbKigLeUhsHujKg,BenjYehuda,41.8815704,-87.6326146,1,45,46,6,5,2,104,4.221153846153846,4,3,0,1,1,9,3.888888888888889
MYtqlLUNcVuMAddtvgK68g,Trenchermen,41.910773,-87.679066,3,169,177,110,75,25,556,3.7014388489208634,19,9,3,12,5,48,3.5208333333333335
LNtuCsJLk3E9y7I5sd5SjQ,Giordano’s,41.8778492,-87.6348295,2,147,207,115,62,50,581,3.5834767641996557,26,28,5,2,9,70,3.857142857142857
Sv1_VhFbQOBc60KfCT5ENg,Travelle,41.8887723,-87.6270493,3,60,43,8,18,8,137,3.9416058394160585,1,2,1,3,1,8,2.875
zbdhMq_8OjSZEHyw_PoQBQ,Flub A Dub Chub’s,41.937176,-87.644011,1,302,151,38,10,2,503,4.473161033797217,43,14,4,4,1,66,4.424242424242424
JOiHzz9wPgLhkxjkrvSMgQ,SP Kebab,42.005643,-87.660959,1,165,47,10,9,4,235,4.531914893617022,45,7,0,1,1,54,4.7407407407407405
qfv0rYo8rAY0DgmL18hZTg,Cuba 312,41.943481,-87.680636,2,54,18,4,6,1,83,4.421686746987952,8,1,0,0,1,10,4.5
fzSR7vIQTQP0cir0Dgi9Vw,Cafe Con Leche,41.9303478,-87.7098741,2,158,160,52,25,21,416,3.983173076923077,38,19,11,0,6,74,4.121621621621622
gs-PZjw3VONWJQFCSTDTeg,Sunset Pho Caffe,41.985793,-87.68989,2,48,13,2,2,1,66,4.590909090909091,10,4,0,0,0,14,4.714285714285714
IRnNJNVlSyhQG0lBfzsZaA,Ain’t She Sweet Cafe,41.8169133,-87.6129524,1,52,52,5,0,4,113,4.3097345132743365,12,12,1,1,4,30,3.9
w-4wkkgQDpu8cadwERS7dw,Meatheads,41.9406717,-87.6880958,2,56,40,8,8,2,114,4.228070175438597,2,4,4,2,1,13,3.3076923076923075
L-qeoX2SWpQcv8wNTj8XoA,I-Cafe Sukur’s Place,41.9543468,-87.674757,1,33,15,4,2,1,55,4.4,5,2,1,1,0,9,4.222222222222222
qNqqqQcTS2vFrtg8NufqtA,The Halal Guys,41.9038947,-87.6305633,1,79,68,50,39,35,271,3.4317343173431736,11,2,1,2,2,18,4.0
V0LaKtF-pEOAH5xyAM6koA,Embeya,41.884707,-87.642277,3,148,131,57,23,24,383,3.9295039164490864,17,5,7,1,2,32,4.0625
U4c5YEldlytVFAv9YoN7qg,Tapas Valencia,41.861047,-87.628152,2,119,173,77,36,9,414,3.86231884057971,22,11,5,4,8,50,3.7
eTjl8rHLGWWhc65cFjcDLA,Trattoria No. 10,41.8824147,-87.6297301,3,117,180,71,27,5,400,3.9425,16,23,2,2,8,51,3.7254901960784315
ZY8aeb2cLxodVilYc32x3w,Bella ‘Mbriana,41.9669104,-87.6673349,1,28,5,0,2,0,35,4.685714285714286,1,0,0,0,0,1,5.0
ZjzBnUIs9Ca5gV2He0UOXA,Jerk Taco Man,41.8767267,-87.7257647,1,33,28,21,11,7,100,3.69,4,2,0,0,1,7,4.142857142857143
jvLbuQkiikJrCTrAOcBc5A,The Brixton,41.9804771616833,-87.6686728745699,2,62,51,9,21,13,156,3.8205128205128207,5,4,0,2,0,11,4.090909090909091
xiMMZSi06MXtvUoKd63iFQ,Rice’N Bread,41.9446344810848,-87.6540841498032,1,67,36,15,4,0,122,4.360655737704918,5,3,0,1,0,9,4.333333333333333
CPj1XHGBsWOFiQpdxOyOxw,Friends Sushi,41.895366,-87.625781,2,287,365,132,49,33,866,3.951501154734411,48,38,10,0,3,99,4.292929292929293
5u27W_xHIKhVbws08lXXJg,Bryn Mawr Breakfast Club,41.98275,-87.713885,2,165,50,21,11,3,250,4.452,14,2,2,0,0,18,4.666666666666667
rgHFY55p10VVur7N3s-z5Q,Roka Akor - Chicago,41.890672,-87.6313456,3,318,196,95,36,26,671,4.1087928464977646,81,16,13,10,30,150,3.72
TqyssEJOYHG2tWCheOVWeQ,Ground Control,41.9173377,-87.7107789,2,90,62,19,11,4,186,4.198924731182796,18,1,0,0,3,22,4.409090909090909
KPQTn3g1aawws-rp6A3hNg,Elizabeth Restaurant,41.9695404,-87.6886355,4,55,24,13,5,0,97,4.329896907216495,18,1,3,0,1,23,4.521739130434782
5D5GiHm67V4thed30Etzhg,Summer House,41.917583,-87.648511,2,283,289,141,77,49,839,3.810488676996424,36,22,8,12,10,88,3.7045454545454546
PEG6gRkU_z89nUcDgyAGFg,Taco In A Bag,41.965057,-87.68603,1,110,39,28,27,16,220,3.909090909090909,15,3,2,1,1,22,4.363636363636363
1AwTFlZTeFxINxC5e9VIpA,Habana Libre Restaurant,41.8962642,-87.6640126,2,99,190,56,25,18,388,3.8427835051546393,10,15,3,1,3,32,3.875
QPr7dxBlnNipJ0R5-GMd-w,Slim’s,41.961707,-87.6798933,1,92,56,4,3,4,159,4.440251572327044,26,9,3,2,1,41,4.390243902439025
1hZJWzpYgUpOMkmGZAewsg,Topo Gigio Ristorante,41.9096594975818,-87.6348415912861,2,220,219,64,32,41,576,3.9461805555555554,56,28,6,4,9,103,4.145631067961165
9oaOBJmN6cAwllSxfewkjw,Breakroom Brewery,41.9611314,-87.7019379,2,52,31,24,13,2,122,3.9672131147540983,3,2,2,0,0,7,4.142857142857143
PC0MdV7m2WtDFsslQj4HWg,Cemitas Puebla,41.8866711553384,-87.6481350252124,2,58,37,19,20,6,140,3.8642857142857143,1,0,1,1,0,3,3.3333333333333335
9j-IauL8jaLM8qIc-8cn7Q,Estrella Negra,41.925175,-87.68706,2,151,150,44,35,14,394,3.987309644670051,42,19,2,5,6,74,4.162162162162162
WjezqZkjqN44OgS14wRo5Q,Emperor’s Choice Restaurant,41.8517333,-87.6322741,2,51,49,13,11,8,132,3.9393939393939394,5,3,0,1,3,12,3.5
0OkOC9LDBTIm9o2s5_WDVw,Strings 2,41.9117729,-87.64794,2,34,29,19,9,11,102,3.6470588235294117,1,1,1,1,1,5,3.0
I30lluFlFXFbbh0s5XNaQw,Legno Chicago,41.958257,-87.767503,2,60,44,17,19,11,151,3.814569536423841,16,7,1,4,2,30,4.033333333333333
lDOKKJxBY2cITgHnKl7AWg,Bethlehem Pita and Grill,41.9535853,-87.6498677,1,33,9,5,4,2,53,4.264150943396227,2,0,0,0,2,4,3.0
b7hhRTWDllSOxj18tIb_QA,MK Restaurant,41.8985482159305,-87.6359440762127,4,444,188,81,34,18,765,4.315032679738562,59,34,10,20,20,143,3.6433566433566433
NxS3CFUBd8XfVzk90lnxAg,The Avondale Bar + Kitchen,41.939372,-87.7187671,2,39,8,4,4,2,57,4.368421052631579,4,0,0,1,0,5,4.4
Kay0151fB9BoQ_AF57Zl2A,Cafecito,41.8823605,-87.6337765,1,144,92,19,9,3,267,4.367041198501872,4,6,2,1,0,13,4.0
IRa05qXL2uU_WotrRgWNiQ,The Marq,41.8796191,-87.6299253,2,56,34,17,13,3,123,4.032520325203252,7,1,0,1,3,12,3.6666666666666665
vYf4Lo0oUZcrVapLH1huBA,Altiro Latin Fusion - Roscoe,41.9429987492712,-87.6816414949396,3,33,8,8,1,0,50,4.46,1,0,0,0,0,1,5.0
eUlykGltBGH0RC5lkwx2eg,Honey Butter Fried Chicken,41.9426302817062,-87.7027218416333,2,270,218,140,96,35,759,3.7799736495388667,18,12,4,7,12,53,3.3207547169811322
F7IQngaDDBgYvhA3U31q-g,Irazu,41.915563,-87.68515,2,618,578,166,68,45,1475,4.12271186440678,104,63,19,9,30,225,3.897777777777778
USPPmi42XS1P2s_BGTTwbg,Restaurante El Mogote,41.9719699,-87.7083599,1,27,5,0,0,2,34,4.617647058823529,3,0,0,0,0,3,5.0
lVdE5QGoxqycuKHrTmoJYg,Bullhead Cantina,41.9022902121953,-87.6964375079613,2,76,92,23,11,7,209,4.047846889952153,14,6,2,0,0,22,4.545454545454546
e5ou75UeqHUsrGg-5uKOIw,AMK Kitchen Bar,41.918028,-87.677403,2,52,29,8,7,6,102,4.117647058823529,7,0,0,1,0,8,4.625
DBtXy8wcPsVr80oFfz-CbA,Nana,41.8345024618078,-87.6460434123874,2,262,266,97,77,47,749,3.826435246995995,51,34,20,14,50,169,3.1301775147928996
4_8FhxYeTF_aAVABL7Fk9w,Big Delicious Planet Canteen,41.8891784,-87.6749737,2,14,9,2,0,1,26,4.346153846153846,2,0,0,1,0,3,4.0
nlzCOQG-8oKBOGMMtbreTg,Nando’s Peri-Peri,41.8813621,-87.6266942,2,18,13,5,1,3,40,4.05,0,0,0,0,0,0,x
0fFLUKl71vv3eNV2xhikEw,Spacca Napoli,41.963223200485,-87.673746893212,2,456,326,119,70,40,1011,4.076162215628091,79,25,14,8,16,142,4.007042253521127
fncJ-Je_BvHtwb0WF5923g,Booze Box,41.8839407476952,-87.6483741123995,2,28,9,3,1,2,43,4.395348837209302,1,0,0,1,0,2,3.5
2mXTTmT65KzUCf_2l-VS-w,The Duck Inn,41.844346,-87.6600349,3,80,36,22,13,8,159,4.050314465408805,4,0,1,0,1,6,4.0
it70fG4Ke0ZfnBjKt8zBLA,Cozy Corner Restaurant & Pancake House,41.9317523,-87.7365797,1,65,41,9,7,12,134,4.044776119402985,18,5,1,2,2,28,4.25
BwCP1X_Z04Aj_z6Tmbhg-Q,Birria Huentitan Restaurant,41.9096907118376,-87.7273342043479,1,33,12,4,1,0,50,4.54,6,4,1,2,1,14,3.857142857142857
Puxl4IMwbkKk1faovYHKqA,The Tamale Lady,41.8531099,-87.6758508,1,26,5,3,3,0,37,4.45945945945946,3,1,0,0,0,4,4.75
V2jEs7sH44pcG1J9x59f9w,Dove’s Luncheonette,41.9095515118731,-87.6773484050924,2,117,101,34,17,7,276,4.101449275362318,2,2,2,4,2,12,2.8333333333333335
uQFHfnbJm7LIxLhjMKc4mQ,Lawrence Fish Market,41.9685184,-87.7259516,1,322,156,33,10,8,529,4.463137996219282,31,12,2,1,3,49,4.36734693877551
fGNGjLrTKb75W94DXiWCxw,Ignotz Ristorante,41.8478039,-87.682759,2,77,57,17,9,5,165,4.163636363636364,22,9,1,0,0,32,4.65625
xBufDNrBoBSjQp_Kg1Xe8Q,Taste of Thai Town,41.9626224,-87.7278467,2,32,9,6,3,4,54,4.148148148148148,8,0,0,1,0,9,4.666666666666667
7xiYs3CWFbs9lnqor7iRpQ,Crazy Bird Chicken,41.8672029,-87.6961833,1,18,4,3,2,0,27,4.407407407407407,4,0,0,0,1,5,4.2
ziIfrqtyupmeNlPAOx6jTw,Quartino,41.893418,-87.628346,2,1070,1197,421,179,56,2923,4.042080054738283,115,92,26,33,42,308,3.6655844155844157
0s0y67JkqMKdwaV3MUpqHA,Taverna 750,41.945451,-87.6489231,2,250,166,59,47,36,558,3.9802867383512543,47,9,5,7,7,75,4.093333333333334
HVWCb4pQSPIqu1aOYHNp4g,Mr. Gee’s,41.924686,-87.738022,1,17,10,3,1,4,35,4.0,6,2,0,0,2,10,4.0
RWULs45ZzaD-OJj5A-Kk8g,LYFE Kitchen,41.8896757,-87.6310569,2,192,132,43,22,16,405,4.140740740740741,31,7,1,2,3,44,4.386363636363637
maBSYcQ5VNAC0f8gDCfb1Q,Torta Haüs,41.9327624214964,-87.6525796204805,1,29,2,0,0,0,31,4.935483870967742,6,0,0,0,0,6,5.0
aAFXOXw0mc7cAde1WG6FoQ,L’ Patron Tacos,41.9319687,-87.6983111,1,445,194,62,40,34,775,4.259354838709678,66,25,7,9,14,121,3.9917355371900825
abHSmzltyVEH0KBAEGeA9w,Dos Ricco’s,41.775289,-87.741787,1,178,68,24,13,17,300,4.256666666666667,30,6,1,1,1,39,4.615384615384615
nd1KFxtZHXIMLqPtgubLpQ,m.henry,41.9856598,-87.6689647,2,627,445,143,66,37,1318,4.182852807283763,64,35,16,12,21,148,3.7364864864864864
cyoEeLb5rc9ZAeTO2dkEUQ,Do-Rite Donuts & Chicken,41.894028,-87.6213298,1,193,107,33,7,8,348,4.350574712643678,9,2,0,0,2,13,4.230769230769231
Z8zsvzJxCP83Ls-EShQJIQ,Real Kitchen,41.9612561,-87.6665041,2,92,32,5,5,2,136,4.522058823529412,26,6,1,0,2,35,4.542857142857143
FfB2sgu0f1dGIKSgYlk5_g,Zoom Pizza Factory,41.9204,-87.66295,1,17,2,1,1,0,21,4.666666666666667,6,0,0,0,0,6,5.0
GIswPZXoc7dR8Z6XbIyOdw,Chavas Tacos,41.8905019,-87.6855497,1,37,39,16,4,9,105,3.8666666666666667,7,12,3,1,0,23,4.086956521739131
fJhF5Yy4nguguaaH3TabmQ,Bandera Restaurant,41.8920699061682,-87.6236613730788,2,437,532,164,57,39,1229,4.034174125305126,70,60,14,9,27,180,3.761111111111111
dAtnrxod4RRg38V3_v5qbQ,Kathy De’s Deli,41.827749,-87.640261,1,32,10,1,1,1,45,4.5777777777777775,4,0,0,0,0,4,5.0
ov3g4g43361kDycs-E6ucQ,Azteca de Oro Mexican Grill,41.949852,-87.658374,1,137,123,36,24,12,332,4.051204819277109,25,8,4,4,5,46,3.9565217391304346
yB7JF4Sr0CgBmymnL1KwRw,Nookies Too,41.9203388,-87.6485961,2,98,159,64,32,11,364,3.826923076923077,12,10,2,3,4,31,3.7419354838709675
T1byj0cyKsnzgPFDPh3NXA,Osteria Langhe,41.91763,-87.6983279,2,82,31,14,4,8,139,4.258992805755396,8,1,1,0,0,10,4.7
26AX3IYq2L_ZgUj7hFr9aQ,mfk,41.9331424,-87.6406827,3,56,25,10,11,1,103,4.203883495145631,4,1,2,1,0,8,4.0
2yB1cFS4YZN1eziiCKHrzg,Old Jerusalem,41.9080551,-87.6343117,2,74,105,44,24,12,259,3.7915057915057915,15,3,5,3,2,28,3.9285714285714284
xypCmZGXwNwayGla_geIAA,The Reservoir,41.9620989014783,-87.6517045497894,2,81,92,18,12,5,208,4.115384615384615,20,5,4,1,2,32,4.25
fM7wQZVC1DRxU6OXgaAmhw,Four Moon Tavern,41.9431194,-87.6758485,2,102,104,19,5,8,238,4.205882352941177,8,13,0,0,3,24,3.9583333333333335
Swa4y3eDN--s7C91VL7frg,Wyler Road,41.922655707111,-87.7167737288361,2,29,23,4,8,5,69,3.9130434782608696,4,2,0,0,0,6,4.666666666666667
FZuVE8sm9To2mPUGwpRBeQ,Windy City Cafe,41.8963542763254,-87.6550798911127,1,74,84,19,9,5,191,4.115183246073299,13,9,3,3,3,31,3.838709677419355
ZYDZM2sxmjR1AjxgKTsGbg,Artango Bistro,41.958154,-87.673391,2,79,52,16,17,22,186,3.8010752688172045,24,7,1,1,5,38,4.157894736842105
LmOCyxWKENwQRlixDlObqw,BIG & little’s Restaurant,41.9400472330334,-87.6555045423279,1,347,176,58,34,16,631,4.274167987321712,34,14,3,17,24,92,3.1847826086956523
EfSiYrSkWfGV6q0G-if6hw,Rockwell’s Neighborhood Grill,41.9658447,-87.6938949,2,97,157,45,14,8,321,4.0,16,19,2,2,1,40,4.175
MPfcgPwCcm3-imbg_BUNcA,Bar on Buena,41.9585856,-87.6536,2,122,205,63,37,18,445,3.844943820224719,15,28,4,3,3,53,3.9245283018867925
F9lD04IZxOH89VPKWPwkuA,Bread & Wine,41.9537951,-87.7216215,2,115,82,47,29,13,286,3.8986013986013988,22,5,3,4,5,39,3.8974358974358974
4-uKJdGyT0iZmu3rbSDwBw,Great Sea Chinese Restaurant,41.9685893,-87.7106426,2,198,202,65,32,26,523,3.982791586998088,22,24,6,5,8,65,3.723076923076923
jlVvQOf4YE3ZO1gMFSAdww,Buona Terra Ristorante,41.9277342,-87.6973756,2,261,181,50,19,9,520,4.280769230769231,37,12,7,3,4,63,4.190476190476191
AkfSndWBxnTn-LpmiL8aLA,Tru,41.8945325,-87.6231486,4,318,124,63,29,20,554,4.247292418772563,44,21,10,21,12,108,3.5925925925925926
nR3zdbYXj7ILf8cdfepbVw,Devil Dawgs,41.9213615,-87.6533064,1,51,39,10,6,9,115,4.017391304347826,15,11,3,1,1,31,4.225806451612903
DZs9lNJ6xbVnAJIxXI7gAw,Salsa Picante,41.8989587,-87.6866192,1,19,6,2,4,1,32,4.1875,4,1,0,0,0,5,4.8
Z7Z0QCpKxJ_1JQcr6mz3VA,Owen & Engine,41.930479,-87.688238,2,360,278,84,39,17,778,4.188946015424165,32,22,6,6,9,75,3.8266666666666667
1Gg16kUQ7bbJ3IHa_u1NXQ,Homestead On The Roof,41.896048193978,-87.6755654811859,3,75,40,20,21,15,171,3.8128654970760234,13,10,4,1,5,33,3.757575757575758
zABUsfcbExmBAfZjO7dI0g,El Carrito,41.9907368061156,-87.7076021281604,1,73,27,14,14,10,138,4.007246376811594,12,1,0,3,2,18,4.0
4wreIFjaPMppyEnzKHbozg,Grand Lux Cafe,41.8929527,-87.624918,2,294,560,300,143,103,1400,3.5707142857142857,79,82,24,11,46,242,3.5661157024793386
Ks4ktQzDBiY58SYDUAfhVg,El Nuevo Mexicano,41.9352732,-87.6470639,2,232,209,44,27,14,526,4.17490494296578,43,30,2,3,5,83,4.240963855421687
tNdXRni2aXW7x6B6T6ztyg,Khaosan & Taylor,41.8697828,-87.6545162,1,28,7,2,2,3,42,4.309523809523809,7,0,0,0,0,7,5.0
WM2JQP4yzQHPbIh-wNdK6g,Cumin,41.9075392,-87.6734123,2,217,275,113,42,26,673,3.913818722139673,29,23,8,13,24,97,3.2061855670103094
4xQ7x-Td1nFshx7J0Bd6pw,Peking Mandarin,41.9683735,-87.7155922,1,43,37,6,2,4,92,4.228260869565218,6,2,2,1,0,11,4.181818181818182
fJkO3cfnNXrLIoYYGBX7_g,"Table, Donkey and Stick",41.91775,-87.695965,2,91,78,46,18,9,242,3.925619834710744,14,3,3,1,4,25,3.88
zv6Np3a15fxtn8isqCFGPg,Park Tavern,41.8772798,-87.6684263,2,34,70,24,12,10,150,3.7066666666666666,6,10,2,1,2,21,3.8095238095238093
lf8WcC4IvzvmvlSmYIoi3Q,The Dock at Montrose Beach,41.9645959121368,-87.6363945007324,2,41,46,30,23,36,176,3.1875,14,6,2,7,8,37,3.2972972972972974
11_xlt0Sn2tlclHwf_Gd9A,Eduardo’s Enoteca,41.9043898,-87.6304671,2,118,50,18,11,15,212,4.15566037735849,31,3,0,0,1,35,4.8
c-2RLpueD2I9m4dYgL9kPQ,Blaze Fast-Fire’d Pizza,41.8931562,-87.6216599,1,71,72,22,5,6,176,4.119318181818182,6,6,2,1,0,15,4.133333333333334
WcKLBTtlkHCpb0XcgYiwBQ,Pierogi Street,41.90056,-87.6966086,2,32,8,3,2,1,46,4.478260869565218,2,1,0,0,0,3,4.666666666666667
sLewp4OTKQYJbDJ7FKZoIw,Señor Pan Café,41.9101638793945,-87.6927871704102,1,69,35,6,8,5,123,4.260162601626016,8,5,1,0,0,14,4.5
CZAVqR6lI50rVbN7E78aHA,Ipsento,41.9186514,-87.6870845,1,423,170,38,18,13,662,4.468277945619335,46,20,3,4,1,74,4.4324324324324325
-MdaMqDSZDvNKoBIlDGlTQ,Las Palmas,41.910266,-87.673935,2,239,201,75,27,16,558,4.111111111111111,26,15,6,3,3,53,4.09433962264151
zcMR0uDgshgPA0rauDlekA,Uncommon Ground,41.9511905,-87.6598598,2,200,315,143,104,71,833,3.563025210084034,27,23,8,16,23,97,3.154639175257732
zF9o33BVqLUOcCmnuB2eQw,Handlebar,41.910086,-87.685301,2,357,421,115,47,29,969,4.062951496388029,45,37,8,13,20,123,3.6016260162601625
N7juvW8YoFIj7sEBzVF8GQ,Simply It,41.923501,-87.6457,2,283,209,73,37,27,629,4.087440381558029,161,35,4,7,6,213,4.586854460093897
33r5J19uqUKJHreIgUBWZg,Primo Chuki’s,41.968915589254,-87.6720987260342,1,42,19,4,1,0,66,4.545454545454546,2,0,0,0,2,4,3.0
PPMAnBtLm9yrnO3lGCV9uA,Sociale Chicago,41.8719817,-87.6306186,2,40,22,7,2,2,73,4.315068493150685,6,1,0,0,0,7,4.857142857142857
CLuaGuxDvRO2IYdWNRw7hw,Benjyehuda,41.8769301,-87.6341989,1,123,124,27,12,8,294,4.163265306122449,11,10,1,3,4,29,3.7241379310344827
sYzkzjM2upp2vW32vPaJ9w,Ghareeb Nawaz,41.997979,-87.681612,1,187,175,49,16,26,453,4.061810154525387,38,21,4,2,37,102,3.2058823529411766
2kNaY86bIQqj1OwNXHwD5A,Chicago Raw,41.8947448,-87.6301154,2,40,10,3,4,3,60,4.333333333333333,8,1,0,1,0,10,4.6
o5y9To9kqcgzUGRt3AzrBg,Ramen Takeya,41.8866402,-87.6483675,2,53,72,20,14,5,164,3.9390243902439024,1,2,0,1,0,4,3.75
lwl1vEEagUrhNXhDI1StQA,Tre Soldi,41.8927539,-87.6220247,2,68,73,25,11,7,184,4.0,14,7,1,0,1,23,4.434782608695652
DDtElQ0VMOox12kb7V7cow,Native Foods Cafe,41.939649,-87.6551,2,214,107,23,14,10,368,4.361413043478261,33,18,1,0,5,57,4.298245614035087
aa2B5osXPyKPsLpBA4ecSw,Freestyle Food & Drink,41.8942152,-87.6283426,2,30,33,12,6,9,90,3.7666666666666666,4,2,0,0,1,7,4.142857142857143
q8H-w31ZLgwXVk2yDMSF0A,Cleos,41.895703,-87.6759971,2,95,162,63,16,11,347,3.9048991354466858,18,12,3,1,9,43,3.6744186046511627
09eEic9nbbSYMRizNfWrLQ,Primos Chicago Pizza Pasta,41.8767808,-87.648221,1,48,36,7,4,6,101,4.148514851485149,15,6,2,0,1,24,4.416666666666667
4Gxtzba86P8mY3ZgFeZ2IA,Hub 51,41.8899784766276,-87.6296997070312,2,292,558,283,101,46,1280,3.74140625,55,66,23,15,45,204,3.3480392156862746
NI7pf7MLGSOfb-YQWEtQDw,The Happy Crab,41.8780173,-87.6478044,2,38,22,5,8,7,80,3.95,9,1,0,1,3,14,3.857142857142857
18hcO-EU7f1ENU4m1tbIBA,Francesca’s On Taylor,41.869426,-87.6617842,2,126,133,46,19,12,336,4.017857142857143,31,22,3,3,5,64,4.109375
49bs7BF03aSi8ZpRuTEDbQ,Pasta and Burger Salon,41.823574778451,-87.7046808600426,2,5,0,0,0,0,5,5.0,0,0,0,0,0,0,x
jBpqtM1uE9eLxi-K2rhKjA,Nico Osteria,41.901285,-87.627429,3,177,123,57,37,15,409,4.002444987775061,17,4,6,5,5,37,3.6216216216216215
qbpo-OPav2tv4TV5C8BFKw,Homeslice,41.9219238,-87.6524653,2,265,159,64,23,16,527,4.20303605313093,49,15,7,5,12,88,3.9545454545454546
LeA-eBkN7UMoFKuHRP_MyQ,Upton’s Breakroom,41.8908805274879,-87.6793019379492,1,49,15,6,1,1,72,4.527777777777778,6,1,2,1,0,10,4.2
nnQ76cjs9WVquy1jDT4DuA,Ceviche,41.9321395,-87.6924947,2,55,19,8,4,8,94,4.159574468085107,4,0,0,0,1,5,4.2
o4NcUfco7JxOcyfKFWyAhg,Mercat a la Planxa,41.8732738,-87.6244472,3,399,405,183,110,45,1142,3.8782837127845884,47,38,13,18,27,143,3.4195804195804196
xJEA6P6VS-Ukl9dmjleDkw,Silli Kori,41.9029432,-87.6793398,2,23,7,3,0,1,34,4.5,0,0,0,0,0,0,x
X4iTO2t4ZsfkiJf_deWnVA,Davanti Enoteca River North,41.890152,-87.627541,2,91,73,42,26,9,241,3.87551867219917,15,4,3,1,2,25,4.16
N4z5WUyXKL73Z2P-t8rV4Q,Authentaco,41.9028,-87.6672861,1,39,22,7,6,3,77,4.142857142857143,0,0,0,0,0,0,x
gExhdOOCWMDECkC354QXag,Taco & Burrito Palace #2,41.927192,-87.6486354,1,84,42,21,9,2,158,4.246835443037975,16,7,2,0,1,26,4.423076923076923
EhuYT2n9zIs_Cl7S0KSY0Q,Smashburger,41.918285,-87.65977,1,32,31,13,11,3,90,3.8666666666666667,6,3,1,0,0,10,4.5
e2Lrtjx60UZKDYa6OJjYzQ,Outdoor Grill,41.94053,-87.725655,1,52,22,6,1,0,81,4.54320987654321,14,5,0,0,0,19,4.7368421052631575
rjR8bVE-XYBL88DAbxPW7g,Horizon Cafe,41.951555581819,-87.649455203806,1,111,108,41,16,15,291,3.9759450171821307,37,19,3,1,7,67,4.164179104477612
0X5prQ8-SG57fL5MRQi_5w,Chez Simo Bistro,41.9688722,-87.6788455,2,54,34,11,5,5,109,4.165137614678899,12,5,1,0,1,19,4.421052631578948
gAp38M1cLRkFHbemMhaNAQ,Le Bouchon,41.9175589,-87.677924,3,133,147,55,19,15,369,3.986449864498645,22,20,6,10,4,62,3.7419354838709675
m8qrUdRl8TCqvW-L6uWVsA,EL Ideas,41.8626841,-87.6868842,4,146,25,9,12,7,199,4.4623115577889445,20,3,3,6,9,41,3.4634146341463414
uLUsX2YRnYcCHmDIVwDBTw,RM Champagne Salon,41.8838395,-87.6488907,3,143,132,41,25,19,360,3.986111111111111,14,11,4,3,7,39,3.5641025641025643
rlG1iZzTGw_9hdHD3o0oDw,The Cotton Duck,41.898897,-87.67677,2,33,7,2,0,1,43,4.651162790697675,10,0,0,0,0,10,5.0
SfaA8AXQVtPY1JtAuJrgaw,La Catedral Cafe & Restaurant,41.846148,-87.709083,2,60,19,15,5,2,101,4.287128712871287,12,3,2,1,4,22,3.8181818181818183
z_qEuUuRWIq4O-YufXHf1w,Giordano’s,41.8958933,-87.6256974,2,421,493,244,145,100,1403,3.7056307911617963,74,47,19,19,22,181,3.729281767955801
IvdOI86_CSCRFpid2atnyA,Davanti Enoteca,41.8691113,-87.6614345,2,472,311,104,50,30,967,4.1840744570837645,53,41,5,9,30,138,3.5652173913043477
NOKQi1saEWWp-cbUhkUtFQ,Velvet Taco,41.902203,-87.6285872,2,213,112,55,16,7,403,4.260545905707196,21,7,3,3,1,35,4.257142857142857
YmjFqRAKsORKGTbtwvFW_A,Bánh Mì BáGet,41.9388529,-87.6443526,1,86,69,31,20,10,216,3.9305555555555554,8,8,1,2,1,20,4.0
0hk0dnOxW3axag0xwlwGKQ,Papa’s Cache Sabroso,41.902681,-87.690204,1,161,122,29,10,19,341,4.161290322580645,25,15,2,0,4,46,4.239130434782608
3aoCOA9tc3Nhi2swyhR-1Q,Bourgeois Pig Cafe,41.9257131,-87.6479024,1,172,276,121,63,58,690,3.639130434782609,31,26,8,7,10,82,3.7439024390243905
PRcDyZVHFCiQ_AOBn66DZw,Morgan Street Cafe,41.879676,-87.651662,1,52,61,16,7,1,137,4.138686131386861,12,9,1,2,1,25,4.16
48LgtDgqtzQpF8KYUb1pJg,Reno,41.9291207,-87.7074855,2,88,112,57,31,10,298,3.795302013422819,14,7,6,1,4,32,3.8125
JGOl4S42CxLJj-s9uyFU2w,Takito Kitchen,41.902895,-87.677842,2,126,103,43,22,8,302,4.049668874172186,29,9,4,1,3,46,4.304347826086956
y8jVBaHh8ntYkVqDXpsi1Q,Cafe Ba-Ba-Reeba!,41.9189708,-87.6488332,2,949,1022,299,151,46,2467,4.085123631941629,155,106,32,11,40,344,3.9447674418604652
T9URPhKXqW1rrcOWCFCsow,Vivial Restaurant & Cocktail Bar,41.9505557,-87.6638315,3,14,3,1,3,0,21,4.333333333333333,3,0,0,0,0,3,5.0
IoJoWPp7dQOjeCfT2ki3cA,Angel’s,41.8779448,-87.6668998,2,95,73,15,8,10,201,4.169154228855722,15,9,0,2,1,27,4.296296296296297
skpDldmlZlw6e82tpiVyrg,Panes Bread Cafe,41.9364776,-87.654266,1,342,201,38,13,9,603,4.416252072968491,46,16,5,2,4,73,4.342465753424658
syFfym4JRuHrT_3cUhuF1g,Bernie’s Lunch & Supper,41.894156,-87.637409,2,28,23,16,8,3,78,3.8333333333333335,2,0,1,2,3,8,2.5
tCkwBTuEFvhuaBoEUWqbuQ,Meli Cafe & Juice Bar,41.87761,-87.647002,2,331,283,87,45,34,780,4.066666666666666,45,29,5,17,21,117,3.5128205128205128
712kvB3m1HLjeBZX2-vaNw,Marcella’s Restaurant,41.924338,-87.714006,1,14,2,0,0,2,18,4.444444444444445,3,0,0,0,0,3,5.0
D-Cl-k6Xkwq6cxIV3rj9Iw,BeeZzee Fresh Food,41.876224,-87.626504,1,29,18,7,4,0,58,4.241379310344827,2,1,1,0,0,4,4.25
JS5mi7IPnfntxujiXtirHw,Jibek Jolu,41.9731894,-87.6912157,2,84,74,17,12,1,188,4.212765957446808,15,4,2,1,8,30,3.566666666666667
5FK-H2Zxcje-OH1FcsdJ5A,Umami Burger,41.908597,-87.675206,2,189,140,70,42,23,464,3.9267241379310347,24,8,6,3,3,44,4.068181818181818
CACn-zDE97gbHogO2VH8fQ,The Art of Chicken,41.9187529,-87.6872596,1,64,59,15,9,2,149,4.167785234899329,7,5,0,0,0,12,4.583333333333333
epdAvPKt726YCe48gD6Ldw,Kerelys Cuban Cafe & Pizzeria,41.9346478,-87.7168702,1,25,2,0,1,1,29,4.689655172413793,3,0,0,1,0,4,4.25
3n35t-1LPBDqWjEzqfAJZg,The Flower Flat,41.9478448,-87.6465988,1,70,45,11,11,7,144,4.111111111111111,22,1,1,4,2,30,4.233333333333333
PiMYIPNSQVHrTprACa3RXw,La Ciudad,41.9640599191189,-87.6546938717365,2,184,108,38,29,14,373,4.1233243967828415,26,7,4,3,8,48,3.8333333333333335
sDYjKyI_67eUhFAqVneYjA,Gilt Bar,41.8893236,-87.6352298,3,490,461,118,47,39,1155,4.13939393939394,67,40,13,8,34,162,3.6049382716049383
m6nj6q3ENqB7R5S4ooM2gw,La Lagartija Taqueria,41.8793836,-87.6668168,2,61,68,19,10,9,167,3.970059880239521,11,3,0,0,6,20,3.65
rp17Dfjdh7JR4GGZwj6nqg,Portillo’s Hot Dogs & Barnelli’s Salad Bowl,41.8935068,-87.6315085,1,1125,1027,369,136,65,2722,4.1061719324026456,185,83,26,13,55,362,3.911602209944751
cTQ3Hm7VUjH32EnjVcb9Yw,The Drinkingbird,41.921841,-87.66418,2,76,66,14,9,12,177,4.045197740112994,20,8,5,2,2,37,4.135135135135135
JPI7g_Q7x6Q6S30a3ic6Mg,Paladar,41.9231462,-87.6879753,2,94,55,20,9,5,183,4.224043715846994,9,2,2,1,0,14,4.357142857142857
T1dv09OKSxmuitPVLXD5Aw,Serai,41.920725,-87.6934179,2,48,22,4,2,2,78,4.435897435897436,2,0,0,0,0,2,5.0
5qvQL4ahXJ02RP_XfAhMGw,Letizia’s Fiore Ristorante & Natural Bakery,41.926507,-87.697808,2,98,68,20,14,6,206,4.155339805825243,24,4,2,3,3,36,4.194444444444445
mvFimrcREBIDo-pLAhMfNg,Avec,41.8842815628402,-87.6433979433133,3,815,483,160,61,35,1554,4.275418275418275,116,53,14,18,32,233,3.871244635193133
8-eWe05s8Z7I1AejHXNsEA,Craft Pizza,41.9048454,-87.6775072,2,36,36,10,7,2,91,4.065934065934066,5,1,0,0,2,8,3.875
0IiTD4sC4_bpy7Mv1H-i9A,The Corner Farmacy,41.8878348,-87.6824467,1,23,3,3,2,1,32,4.40625,1,0,0,0,0,1,5.0
20q-oWtQdB2tfFbAl_I9sQ,Umai,41.873,-87.630961,2,139,174,64,19,13,409,3.9951100244498776,16,35,10,0,15,76,3.486842105263158
kJjbElns3_GTNIklRVbHPQ,Remington’s,41.882656,-87.624993,2,76,37,17,9,2,141,4.24822695035461,11,1,1,1,4,18,3.7777777777777777
E9WVm9nmDwLcctMZb64tQA,RoSal’s,41.869665,-87.656401,2,90,70,20,18,7,205,4.0634146341463415,36,5,1,4,1,47,4.51063829787234
4qvjUbxYdJdx5cBabgV8tg,Pork Shoppe,41.9394139648629,-87.6973467116393,2,187,183,65,40,19,494,3.9696356275303644,33,20,9,6,15,83,3.602409638554217
euO3-H92LCivH2B0CQPlnw,Chicago q,41.903617442969,-87.63023965658,2,531,454,189,103,27,1304,4.04217791411043,73,32,18,14,10,147,3.979591836734694
ohvgBWp16tBn8j8T9hmRqA,Venezuelan Bowl Grill,41.9261293,-87.6501791,2,34,13,3,1,0,51,4.568627450980392,5,0,0,0,0,5,5.0
UZxwiV_OEZJiiHWnSVQ7lA,Rub’s Backcountry Smokehouse,42.0082971888174,-87.6903662458062,2,194,129,46,24,31,424,4.0165094339622645,42,22,2,10,4,80,4.1
NHCYS3udwbhO6qKeXx04hA,Ay Ay Picante Peruvian Cuisine,41.964117,-87.734116,2,156,167,54,25,23,425,3.96,34,20,4,1,20,79,3.5949367088607596
oQX8MSjF2j3pWW7AfWl4eA,Hot”G”Dog,41.972838,-87.6678532,1,45,65,20,5,0,135,4.111111111111111,6,4,1,1,1,13,4.0
LQkrQF7DMfSIVywxysvjcQ,Half Shell,41.9329689,-87.6465708,2,196,215,58,47,52,568,3.8028169014084505,22,21,10,3,8,64,3.71875
Gl3QRXeJI8JGtGdCfHp8Dg,Cozy Noodles & Rice,41.9452487,-87.654386,1,321,268,98,79,46,812,3.9100985221674875,60,31,9,8,9,117,4.068376068376068
Bb3AQCst7df3YF0RD1D5Og,Cafeteria Yesenia,41.816394,-87.665546,1,15,13,2,0,0,30,4.433333333333334,2,2,0,0,0,4,4.5
CA-dFnJCCicrXjPUThysFQ,Bistrot Zinc,41.902964,-87.62836,2,141,161,85,38,11,436,3.878440366972477,24,18,2,4,6,54,3.925925925925926
XKUZV9O2sRFLDIpAmwmG5g,Boka,41.9135158,-87.6480859,3,410,238,116,58,11,833,4.17406962785114,33,20,12,18,2,85,3.7529411764705882
0fYNLK7VpBUW4mgFyPCrWQ,Over Easy Cafe,41.9718545,-87.6790491,2,537,315,76,38,21,987,4.326241134751773,57,37,7,8,10,119,4.033613445378151
1uqwWskpD_i2Icx0f9S8jg,Roti Mediterranean Grill,41.8829824,-87.6290658,1,73,115,32,19,6,245,3.938775510204082,13,3,2,1,7,26,3.5384615384615383
lRONL70W17LB8Hf7o_nG_Q,Atlas Brewing Company,41.9319149,-87.6572838,2,51,72,48,30,16,217,3.5161290322580645,5,4,1,2,2,14,3.5714285714285716
dSqRMhGNCWuSjPT_4lsZqw,Siena Tavern,41.8890426,-87.6301564,3,428,307,103,59,29,926,4.129589632829374,39,24,10,8,10,91,3.8131868131868134
mkFBCrtICVpEVOq-_4tBcQ,Tiny Lounge,41.96110492394399,-87.683969882915,2,148,139,34,16,13,350,4.122857142857143,18,9,9,4,2,42,3.880952380952381
mCHto10PBQOKnefm7gholg,90 Miles Cuban Café,41.9176864624023,-87.6918029785156,2,464,446,159,81,56,1206,3.9792703150912105,76,40,12,9,20,157,3.910828025477707
ahp1F4QC_8nqrbw5jAvGPA,Cozy Corner Restaurant & Pancake House,41.9223785,-87.6970022,1,146,158,62,18,26,410,3.926829268292683,17,12,3,5,6,43,3.6744186046511627
8aovXVzaXjfBhZoiNEPfXg,Tacos El Picapiedra,41.905079823886,-87.6672506332397,1,14,0,0,0,0,14,5.0,2,0,0,0,0,2,5.0
6KU3ylSh27qiiBa-a9vOGQ,Union Sushi + Barbeque Bar,41.8940757,-87.6354284,3,266,253,107,52,25,703,3.9715504978662874,55,23,11,3,7,99,4.171717171717172
wehHaAAnkl1G51jRnkNEVg,Oasis Cafe,41.8826234,-87.6257996,1,130,135,48,16,7,336,4.086309523809524,17,5,2,0,1,25,4.48
KomhK0JD5cleEW55YTw7MQ,Sun Wah Bar-B-Que,41.9739769,-87.6595353,2,419,391,115,65,70,1060,3.9660377358490564,36,32,8,11,41,128,3.0859375
FNXQQX_Tz9fGtLI3t-1sFQ,Mortar & Pestle,41.9380974,-87.6443622,2,44,5,7,6,1,63,4.349206349206349,5,1,0,0,0,6,4.833333333333333
zEBMoH7ibF3YZrlowkv88A,Brgrbelly,41.9530335,-87.7709816,2,193,94,31,13,8,339,4.330383480825959,35,17,3,0,1,56,4.517857142857143
HSitGmiKzqS-BySlan18UQ,Yard House,41.9082411,-87.646727,2,21,25,13,5,5,69,3.753623188405797,4,0,0,1,0,5,4.4
BH97RhYMRVGQhxE0kK97_w,Cup & Spoon,41.9101546945704,-87.6877036943947,1,54,20,3,2,0,79,4.594936708860759,7,6,0,0,0,13,4.538461538461538
uyi_j8Lce7PMmOIKMKU8dw,First Slice,41.961763,-87.67353,1,45,61,4,3,3,116,4.224137931034483,5,1,2,0,0,8,4.375
s3Hwq1VXyQ_3dpqzkluRvQ,The Angry Crab,41.9845824,-87.6971593,2,218,141,60,24,18,461,4.1214750542299345,17,12,7,1,4,41,3.902439024390244
fsOruDKYsS5_iGV-Y7P4Nw,Pizzeria Da Nella,41.9249743,-87.6649895,2,76,49,21,18,7,171,3.9883040935672516,9,6,0,3,7,25,3.28
AaPS1hh83RZhC2mX7EwPpw,Tommy Gun’s Garage,41.8536135,-87.625748,3,57,22,10,5,4,98,4.255102040816326,12,11,1,2,3,29,3.9310344827586206
Xdw3MKpWyEfED9Ba5uiAmQ,Sam & George’s,41.9362447,-87.6642434,2,162,115,43,25,17,362,4.0497237569060776,18,9,1,3,3,34,4.0588235294117645
UmumgsnMBHjvVEzZMQxtRg,bopNGrill,42.002840213503,-87.661120406701,2,251,205,68,40,21,585,4.068376068376068,22,12,5,4,3,46,4.0
v6yEtoK0qegbjs1gMl7Xjg,Polk Street Pub,41.872136,-87.6413835,2,38,33,8,10,10,99,3.797979797979798,8,5,0,1,5,19,3.526315789473684
VLWOyf29p5DXfXYcdkkGGw,Blackwood BBQ,41.881133,-87.6411791,1,34,21,8,1,0,64,4.375,4,2,0,1,0,7,4.285714285714286
xdx3hwHT-m6_heZrKyH7vg,The Chicago Diner,41.9238565,-87.6982632,2,208,106,29,15,8,366,4.341530054644808,23,4,1,1,0,29,4.689655172413793
kdobEvkH_YHleJvLLxzb6A,A Tavola,41.8959773,-87.6814137,3,148,91,29,8,8,284,4.278169014084507,29,7,2,5,3,46,4.173913043478261
-W8rtYk_mBsgoQHYVxAh2g,Cheesie’s Pub & Grub,41.9400403,-87.6538326,1,300,273,149,72,53,847,3.820543093270366,51,26,7,7,16,107,3.8317757009345796
6EiFN9NS9BQnqw8FXWiY4A,Forno Rosso Pizzeria Napoletana,41.9476018,-87.8066082,2,196,43,20,7,9,275,4.490909090909091,33,5,2,1,6,47,4.23404255319149
KjHdL-nV4Atc4Cprz3GzBA,The Pasta Bowl,41.91072,-87.674674,2,38,16,4,3,6,67,4.149253731343284,1,1,0,1,0,3,3.6666666666666665
FsoEVqFK-W7gRu0hDH84sg,Janik’s Cafe,41.9030612,-87.677777,1,143,127,44,18,11,343,4.087463556851312,25,11,3,1,1,41,4.414634146341464
3Q_N0K28SRJbPy2sz0QqVw,Prime & Provisions,41.8864291794806,-87.6327307908517,4,146,44,21,19,6,236,4.2923728813559325,24,1,3,1,1,30,4.533333333333333
hxq4TNNazA-sjqFvVgx_Pw,Bongiorno’s Italian Deli & Pizzeria,41.8898017,-87.626024,1,150,86,21,13,19,289,4.159169550173011,33,8,0,1,3,45,4.488888888888889
W8VRkpQ2iKIyt8s1fny1pw,Seasons 52,41.891596,-87.6268111,2,120,77,33,8,12,250,4.14,19,8,1,0,0,28,4.642857142857143
3NV3TTsKGqW1WEbEQv_yBA,Chengdu Impression,41.9286079,-87.648514,2,74,50,9,9,22,164,3.8841463414634148,19,6,1,1,7,34,3.8529411764705883
dju6KZJzLWPHkP_b-V8uyw,The Red Lion Lincoln Square,41.9680511,-87.6935818,2,36,43,16,11,4,110,3.8727272727272726,14,5,0,2,2,23,4.173913043478261
4UMVbAckoHU21bqrhTv4PA,Chef Luciano,41.8526739,-87.6250377,2,42,23,17,9,5,96,3.9166666666666665,9,3,0,1,3,16,3.875
TAueIovlJFslHSVEfnAaaA,DryHop Brewers,41.9390448,-87.6443566,2,136,161,70,31,18,416,3.8798076923076925,14,10,4,3,6,37,3.6216216216216215
-sQAdsG5rFgpBDkaO6qYwA,Zam Zam Middle Eastern Grill,41.9451448,-87.6546564,1,81,24,1,7,2,115,4.521739130434782,11,2,1,0,0,14,4.714285714285714
SS35Cso7FMrHnwDYYrfL7Q,Palace Grill,41.881673,-87.6625,1,120,80,28,12,7,247,4.190283400809717,30,0,5,0,0,35,4.714285714285714
n99qEoKGGdFG6p_rHzK_Cw,Lou Mitchell’s Restaurant & Bakery,41.8777674,-87.6420774,2,176,211,111,59,53,610,3.6524590163934425,19,16,8,10,13,66,3.272727272727273
xT_ZLdD5JSZol2PLfPijiw,Home Style Taste Chinese,41.8353576660156,-87.6463394165039,2,38,40,3,2,3,86,4.255813953488372,2,0,1,0,0,3,4.333333333333333
IACTngt-bZGrhzflliIx7w,Yolk River North,41.895988373432,-87.633949116659,2,290,383,156,53,26,908,3.944933920704846,41,44,19,10,11,125,3.752
mzdaPepjOxUCqA7AwOr7kQ,Taqueria Mazamitla,41.9391835562765,-87.7177961519554,1,30,23,1,2,0,56,4.446428571428571,4,2,0,0,0,6,4.666666666666667
WOZOYdJvYVunwlU136jHlg,Cafe Bella,41.9244942,-87.7110227,1,84,100,32,19,20,255,3.819607843137255,38,8,3,5,3,57,4.280701754385965
emwETJLmITVycIPNAO_toQ,Stella Barra Pizzeria,41.917583,-87.648511,2,75,86,40,23,10,234,3.824786324786325,12,9,0,1,4,26,3.923076923076923
ntLthO5cQDnwn-vKiT3WxA,Zaytune Mediterranean Grill,41.8370666503906,-87.6508560180664,1,135,108,29,8,11,291,4.195876288659794,24,7,2,2,2,37,4.324324324324325
7F3XIOUe0QVNENjNZ3baQg,LC Pho,41.9684262783405,-87.6978502586425,1,38,14,1,0,0,53,4.69811320754717,7,0,0,0,0,7,5.0
bCgWDGyD3G2ULKMB6bQa_w,Butterfly Sushi Bar & Thai Cuisine,41.890911,-87.656212,2,238,365,131,40,42,816,3.8786764705882355,34,45,10,12,33,134,3.2611940298507465
vxoQdpmrko42MTuXfvb_yQ,Jaiyen Sushi & Noodle,41.9392709,-87.6976029,2,53,39,13,7,5,117,4.094017094017094,4,3,1,1,0,9,4.111111111111111
Lr4tZOsttQT-BgFtUkUTaQ,TáKoz,41.868725,-87.682361,1,18,11,1,2,0,32,4.40625,3,0,1,0,0,4,4.5
TabmV_pGsfKPtA6apSPZUg,Glaze Teriyaki Grill,41.9381318,-87.6444533,2,30,14,8,6,4,62,3.967741935483871,4,1,1,0,0,6,4.5
J8aqt4ZcpNuOusJMndUPLg,Cafe Vienna,41.928489,-87.642033,1,211,157,46,16,22,452,4.148230088495575,44,14,3,3,6,70,4.242857142857143
lgjRFg3M-1N416W41DHsTQ,Wasabi,41.919671,-87.691973,2,456,351,111,47,40,1005,4.1303482587064675,34,28,5,6,27,100,3.36
-GiApkLFH7P777PmgXUhQw,Diana’s Food & Restaurant,41.899388,-87.699611,1,6,2,0,0,1,9,4.333333333333333,4,0,0,0,0,4,5.0
0lbMnxIqYSeiXacea56DTg,Bombay Wraps,41.8927337,-87.619067,1,38,43,19,8,3,111,3.945945945945946,7,0,1,0,0,8,4.75
AWfz3Pte-rtbsjMnWJBb5A,Yummy Yummy Noodles,41.8550594,-87.6320696,1,19,9,3,1,2,34,4.235294117647059,1,0,0,0,0,1,5.0
H-Bb2G3PixdNRONKEyX-Pw,Tony’s Burrito Mex,41.9393661,-87.6781535,1,123,85,24,11,7,250,4.224,24,9,3,4,3,43,4.093023255813954
xoi7Cw7FoknAx5p880RtWQ,Au Cheval,41.8846582,-87.6476668,2,1347,720,228,99,98,2492,4.251605136436597,150,84,31,15,43,323,3.876160990712074
mWDZVQxJ5p6aNp7ipa6DEQ,Sumo Sushi & Hibachi Grill,41.9359841,-87.6444608,2,68,18,3,5,2,96,4.510416666666667,8,2,0,0,0,10,4.8
oRGssT00dUHFa_2GvOhgog,WHISK,41.8961206,-87.6778316,2,147,126,43,25,34,375,3.872,17,8,2,3,3,33,4.0
jpNBqkHd8gh3ZJnwR1aubg,Troy Mediterranean Grill,41.935216,-87.644337,2,89,39,10,2,4,144,4.4375,28,4,2,0,3,37,4.45945945945946
iw1_4RySfJpOMvuZ73XAvw,Bienmesabe,41.961399,-87.6706149,2,18,6,3,3,3,33,4.0,1,2,0,0,0,3,4.333333333333333
91ARglBbekWzfpcouA1GtA,Beograd Cafe,41.9538396,-87.7021041,2,54,43,6,4,6,113,4.1946902654867255,12,8,2,0,4,26,3.923076923076923
8d_DiHWB-pjBVW3a7D8EWg,Sunda,41.8909757,-87.6316882,3,662,707,268,149,75,1861,3.9306824288017195,160,79,33,24,65,361,3.6786703601108033
14dFm81gm4Kb8C0nd7wcmQ,Doc B’s Fresh Kitchen,41.900246,-87.625163,2,156,106,17,14,6,299,4.311036789297659,9,7,0,2,3,21,3.8095238095238093
UKs05XWhbP0riI8O0Kv36w,Boeufhaus,41.8998144,-87.6873405,3,85,14,8,6,4,117,4.452991452991453,5,2,0,0,0,7,4.714285714285714
Tkcjl_dPhBqx_8b59WByAA,Taco & Burrito Express #3,41.9101864,-87.6673674,1,44,22,12,2,1,81,4.308641975308642,9,2,0,0,1,12,4.5
OJctw29lDizc_Ei4oueUTA,La Crêperie,41.934059,-87.645708,2,181,216,101,41,17,556,3.9046762589928057,36,14,11,8,2,71,4.042253521126761
AWtX75h91qeXQ3Yf3ho3ng,Fennel & Iris,41.939938,-87.670761,2,22,12,2,2,4,42,4.095238095238095,2,0,0,0,1,3,3.6666666666666665
NgRSMLRzUQgQw3jBuKaJFw,Branko’s Sandwich Shop,41.9255167,-87.6568387,1,51,38,13,6,0,108,4.2407407407407405,7,2,0,0,0,9,4.777777777777778
aOPvO5JFJY7U8abN62Tt9g,Pastoral,41.9359523,-87.6442537,2,131,79,14,10,11,245,4.261224489795918,15,6,0,3,3,27,4.0
7anYcnA31hn15ZMLXgWEDw,Cobra Lounge,41.8862415,-87.6668109,2,77,97,43,13,16,246,3.83739837398374,14,9,6,1,10,40,3.4
hBFVeAfu6bSf3twPcLmNcw,Blaze Fast-Fire’d Pizza,41.8811661,-87.6411785,1,57,24,6,6,3,96,4.3125,5,2,1,0,1,9,4.111111111111111
PynQtVMw55Maam0ah-Zr-A,Cafe & Deli Ballou,41.8987554,-87.6866006,1,91,51,14,5,5,166,4.313253012048193,24,6,2,0,1,33,4.575757575757576
7FRba2yDi9uWlSBvahRmEw,Minghin Cuisine,41.8851133316306,-87.6191340577136,2,34,36,5,6,6,87,3.9885057471264367,3,0,0,0,0,3,5.0
Ot1sgtVfvjtBYSaQS82Png,Nookies,41.9142692,-87.635125,2,157,188,78,36,11,470,3.9446808510638296,35,17,4,2,4,62,4.241935483870968
boE4Ahsssqic7o5wQLI04w,The Purple Pig,41.89101954311,-87.6245617816512,2,1808,1429,427,227,126,4017,4.136669156086632,258,175,54,37,118,642,3.6510903426791277
05GwpjYAVdYBFoxUnSBZKQ,Big Bricks,41.9512941,-87.6769732,2,99,97,20,25,21,262,3.8702290076335877,20,7,3,8,7,45,3.5555555555555554
akNWSB-B3gGNFfdd3AMR3Q,Kate’s Thai Kitchen,41.9025752913958,-87.667669669692,x,6,4,1,1,0,12,4.25,0,0,0,0,0,0,x
0jxO2gCuNI6rTz9R1xHBig,First Slice,41.9661744,-87.7010771,1,37,23,7,3,0,70,4.3428571428571425,5,2,0,0,1,8,4.25
CYUdZSdYJuCC6IMawHpl1g,Bottlefork,41.8903819,-87.6309651,2,218,148,95,37,12,510,4.025490196078431,25,3,3,1,2,34,4.411764705882353
iXzQYelNxUuP1XsMDvEsLw,La Cocina,41.8854358,-87.6356978,1,48,67,13,9,5,142,4.014084507042254,7,4,0,0,1,12,4.333333333333333
6WE3zP14Azd0xM6Hk7C8Pw,Farmhouse,41.8968587,-87.6354014,2,285,340,129,92,22,868,3.891705069124424,35,29,5,8,4,81,4.0246913580246915
1PMp9MqVvqmZ5n3kN_TO2w,Krung Thep Thai Cuisine,41.9402454729157,-87.6490915080368,2,50,16,11,3,3,83,4.289156626506024,5,1,0,0,1,7,4.285714285714286
vyyTRcWa5AfRKcPC9ozn5w,Angelo’s Wine Bar,41.9613987,-87.704368,2,69,20,9,4,3,105,4.40952380952381,5,1,1,0,1,8,4.125
2tKMs0DbdxPSl2JeCJUEKw,"Joe’s Seafood, Prime Steak & Stone Crab",41.891704,-87.625451,4,995,411,129,61,25,1621,4.412708204811844,184,63,25,15,27,314,4.1528662420382165
OGGtHsXsCUHaLkyUNZVXNg,The Dawson,41.8913734,-87.6470872,3,169,159,67,31,22,448,3.9419642857142856,18,13,3,5,4,43,3.8372093023255816
WA-uUSoCOc-nIcrjMjL5Qw,Stock,41.9143025,-87.6630877,1,4,0,0,0,0,4,5.0,1,0,1,0,0,2,4.0
qGptMIlnPokCncB9QSAW4A,Bombacigno’s J & C Inn,41.8769626,-87.6415838,1,57,49,7,6,4,123,4.211382113821138,7,2,0,0,2,11,4.090909090909091
2lVErlFityc8fex-T_3_GQ,Cassava,41.9428515,-87.6532023,1,94,46,9,4,4,157,4.414012738853503,13,4,0,0,2,19,4.368421052631579
wl-48uPlP-7RTC1p7sJEyw,Nando’s Peri-Peri,41.8840603,-87.6517478,2,142,87,36,16,7,288,4.184027777777778,7,1,1,1,1,11,4.090909090909091
8BXbNpuPz_WR92_LE8V8kQ,Naf Naf Grill,41.8831067876924,-87.6356236439325,1,69,61,21,14,10,175,3.942857142857143,15,4,0,0,2,21,4.428571428571429
dsNOMy73KW_eP6ZtecZqCg,3 Greens Market,41.8901676,-87.6378238,2,2,4,2,1,1,10,3.5,0,0,0,0,0,0,x
1hRGm-jTHB-KKBwS8GNxrw,Sweet Maple Cafe,41.869123,-87.660678,2,208,210,81,43,20,562,3.9661921708185055,25,18,7,6,9,65,3.6769230769230767
Yu9xRLlUFdNanAzUqPoqPA,The Bento Box,41.9178602,-87.6843712,2,88,46,8,4,2,148,4.445945945945946,17,4,0,1,0,22,4.681818181818182
Mmr4jOdrjBKn8OFUHib2xQ,Salsita,41.9494678,-87.6497032,1,50,18,5,2,1,76,4.5,5,1,1,0,2,9,3.7777777777777777
HAi1irLE91wjLJo5Qiskpg,Brazilian Bowl,41.940289,-87.644679,1,129,77,30,22,20,278,3.9820143884892087,26,8,1,2,5,42,4.142857142857143
DZA3TUt2WmA5GqwbHZ7tdA,Paramount Room,41.8896546,-87.6448036,2,114,211,95,53,20,493,3.7018255578093306,18,22,3,2,7,52,3.8076923076923075
NGfbRjWoqUh2fGw8DU_pmA,Caro Mio,41.9651506,-87.6758369,2,197,159,62,42,22,482,3.9688796680497926,26,16,4,9,26,81,3.0864197530864197
ahFb5vmsXzhh8tHqyHyddg,Bartoli’s Pizzeria,41.946666,-87.678302,1,83,35,11,10,7,146,4.212328767123288,16,4,2,1,2,25,4.24
QtdN1l7srggbmpyEMa-UDg,The Windsor,41.8951635,-87.6230283,2,25,13,4,3,1,46,4.260869565217392,3,0,1,0,2,6,3.3333333333333335
dkN4tBckgSUM39_yI5eGEA,Broken Shaker,41.892353,-87.6273233,2,51,28,4,6,3,92,4.282608695652174,4,1,0,0,0,5,4.8
l7ggF7b0SiZbGybcTqMihQ,Pizzeria Del Mercato,41.8866698,-87.6563886,2,65,36,10,5,3,119,4.302521008403361,8,3,0,1,1,13,4.230769230769231
4i9LUrKeoMmUB_qZicuJnQ,Cafe Selmarie,41.9674037,-87.6877468,2,214,252,63,33,13,575,4.08,40,20,14,3,4,81,4.098765432098766
TjXpq3ngGSwnp8mLf1fMZA,Talay Chicago,41.8818136252301,-87.6578739884018,2,47,32,7,12,7,105,3.9523809523809526,6,4,0,1,1,12,4.083333333333333
6a_deomxlTJf4oXKxnAG3Q,Mas Alla Del Sol,41.9884118474889,-87.6604411700977,2,81,36,8,5,3,133,4.406015037593985,13,5,0,1,2,21,4.238095238095238
KlKX64yX8IyE8q6DqFZ_6g,Kai Sushi,41.866433,-87.626953,2,185,104,24,10,7,330,4.363636363636363,9,3,3,1,2,18,3.888888888888889
_TvVfx_J0561zmjPXGr4qA,Chop Shop,41.910125,-87.678769,2,66,59,39,30,23,217,3.5299539170506913,10,3,1,3,7,24,3.25
pVPyt3TugMd8FW5LGznkQQ,Kuma’s Corner,41.9395163,-87.7004471,2,2221,1324,562,292,210,4609,4.096550227815144,500,289,94,46,260,1189,3.6080740117746006
M-oT4HcJHDaRp_hmjDoi2g,Bistro 18o,41.858027,-87.667822,2,31,16,3,1,3,54,4.314814814814815,4,2,1,0,0,7,4.428571428571429
UwZE-wYxFYnbRcsrWcIVxg,River Valley Ranch & Kitchens,41.965285053298,-87.6757046380287,2,113,28,12,8,3,164,4.463414634146342,9,4,0,1,0,14,4.5
WlSHFjdaeKUxxD1bJFAUeQ,Charlatan,41.895933,-87.660558,2,80,56,20,9,6,171,4.140350877192983,2,4,1,2,0,9,3.6666666666666665
PzPyHLmRSH2ofemXEShkbw,Luxbar,41.901779,-87.627639,2,131,247,138,40,20,576,3.7447916666666665,29,17,9,4,5,64,3.953125
5N4g9tt8RCuZf0Hte94Oxw,Staropolska Restaurant,41.936365,-87.719246,2,198,86,19,5,4,312,4.503205128205129,22,6,1,0,2,31,4.483870967741935
dGfNWW68dOxs6MnDrOoprQ,Beat Kitchen,41.9397573,-87.6809281,2,58,105,40,20,10,233,3.776824034334764,10,7,4,2,7,30,3.3666666666666667
8vFJH_paXsMocmEO_KAa3w,Lou Malnati’s Pizzeria,41.8903431,-87.6338062,2,1061,863,386,146,93,2549,4.040800313848568,172,80,32,15,52,351,3.868945868945869
zNo9YQLC_5XlpAx_luWjJg,SpritzBurger,41.9514989286766,-87.6494791189686,2,45,35,19,12,4,115,3.9130434782608696,13,2,1,1,1,18,4.388888888888889
FGNKtLYZphTlIjlMGPMuTA,Momotaro,41.8858362394937,-87.6485168502935,3,209,88,40,21,13,371,4.237196765498652,8,5,2,2,1,18,3.9444444444444446
RxHAdNiJ8jPUQDvLz6mDwg,Isla Pilipina,41.9682042,-87.6916607,2,261,182,45,26,14,528,4.231060606060606,24,15,1,9,18,67,3.2686567164179103
sjKS3BR3LJub0GRob_Gvog,Pita Heaven,41.8660469055176,-87.6242828369141,1,77,89,32,18,8,224,3.9330357142857144,22,5,0,4,5,36,3.9722222222222223
s1JPKx5lAeoq7QU8pmN-5A,MingHin Cuisine,41.8541674501305,-87.6339049012164,2,343,496,219,93,47,1198,3.830550918196995,91,99,23,5,296,514,2.385214007782101
m5_GCJP2W4zEJnyVgxa3eA,Longman & Eagle,41.930156679293,-87.707222394898,2,864,605,209,106,61,1845,4.1409214092140925,85,50,12,14,45,206,3.563106796116505
0srfxQZRCL00GAJzANJl0g,The Panini Republic,41.9331455,-87.6416574,1,120,14,7,3,2,146,4.691780821917808,17,2,0,0,0,19,4.894736842105263
gYj6ODoU3tf7TWNv-Kg2Xg,CRĪO Bar and Restaurant,41.927002,-87.6722383,2,97,47,18,7,1,170,4.364705882352941,11,6,1,1,0,19,4.421052631578948
8asUBBy_fFlqLgNQoqQaIw,Taco Joint,41.91791,-87.648371,2,253,246,80,40,23,642,4.037383177570093,28,26,7,5,9,75,3.7866666666666666
eoOZJ9-R0eY30ouPEnqP2w,Shokran Moroccan Restaurant,41.953504,-87.728805,2,163,97,24,15,5,304,4.309210526315789,42,12,4,4,3,65,4.323076923076923
ISHl0cSIx-bHvmUblXEdTg,Dusek’s,41.8578893691301,-87.6574169844389,2,200,176,64,38,14,492,4.036585365853658,19,18,4,25,36,102,2.5980392156862746
XeJGQxpkh5HTQMClZSIkPA,Frontera Fresco,41.8838906,-87.6275643,1,80,144,57,18,7,306,3.888888888888889,9,3,0,2,3,17,3.764705882352941
v_klbNcbuKdcW9mWKlZKiA,New England Seafood Company,41.94277,-87.670419,2,136,147,55,30,28,396,3.840909090909091,17,8,3,3,12,43,3.3488372093023258
Ry1UR5Am0h2QqT8f1DJqFQ,Pizzaiolo,41.9492517,-87.6484464,2,12,2,0,0,0,14,4.857142857142857,5,0,0,0,0,5,5.0
7TM54ucsPHmrSEKjF81Beg,Toast Two,41.9190939,-87.6779558,2,147,173,57,39,21,437,3.883295194508009,12,9,5,7,10,43,3.13953488372093
ncx9jZpjFZxKSZHB94rFkg,Nando Milano Trattoria,41.9033744,-87.6804133,2,146,57,19,21,9,252,4.23015873015873,30,5,3,12,18,68,3.25
_i1Ze7erybep0lKphezj9w,The Jibarito Stop,41.8578068605835,-87.6678551616172,1,29,7,2,2,1,41,4.487804878048781,5,1,1,0,0,7,4.571428571428571
NzTK1ZgqdzzOCbgxXWtvOg,Gyu-Kaku Japanese BBQ,41.884454,-87.661355,2,26,8,3,7,4,48,3.9375,3,1,1,0,0,5,4.4
yl5ARTiRX72sBSDzwCpJKA,Uptown Pho,41.9733709,-87.6551679,1,83,29,4,4,3,123,4.504065040650406,1,0,0,1,0,2,3.5
mxpOEv34XR2DrjjGBrSYxQ,bopNgrill Belmont,41.9399377250105,-87.6523802644181,2,25,18,3,1,4,51,4.1568627450980395,1,1,0,0,0,2,4.5
-NLBAIP5O8BYqbPg0toNog,El Habanero,41.9247448,-87.7108364,1,137,34,9,6,4,190,4.5473684210526315,21,5,1,0,1,28,4.607142857142857
ENfiSGbuKEI0UUKPWPJqtQ,Pastoral,41.8856078,-87.6259252,2,261,186,42,18,14,521,4.27063339731286,15,16,3,6,12,52,3.3076923076923075
UHmZ55OEMJ5NdedgACfxgg,Tufano’s Vernon Park  Tap,41.8728752,-87.6540169,2,94,108,38,21,23,284,3.806338028169014,29,11,2,6,8,56,3.8392857142857144
6stjHiOWQJZjzlGGZDGdUg,Ruby’s Fast Food,41.9612864,-87.7220765,1,88,44,13,2,3,150,4.413333333333333,9,1,0,1,2,13,4.076923076923077
sNQglz_HoXgnUi1KTN3Iew,Gibsons Bar & Steakhouse,41.901407,-87.628091,3,561,356,145,75,47,1184,4.105574324324325,126,68,20,24,36,274,3.8175182481751824
VzkF5Yw5Gb83tESIUhyIhQ,Luke’s Lobster,41.8841172,-87.633052,2,58,42,16,7,3,126,4.150793650793651,3,3,0,0,1,7,4.0
2tSZFYfCPPBGdyh1PTQAvQ,Anna’s Asian Grill & Sushi Bar,41.954543,-87.67455,2,91,43,14,11,6,165,4.224242424242425,9,0,0,0,0,9,5.0
SCkRTMcs6ya1KSm8Qm4ikA,Pearl’s Southern Comfort,41.979491,-87.660043,2,86,35,21,20,3,165,4.096969696969697,8,1,0,1,1,11,4.2727272727272725
kdIJtpWmVhGDsgGyOyhzKg,Birrieria Zaragoza,41.8044718,-87.7237637,2,192,43,8,8,12,263,4.501901140684411,35,5,2,1,0,43,4.72093023255814
sS396p8R1nT0m_rhELJ4Jg,Bridge House Tavern,41.8880653,-87.6307608,2,154,151,65,47,28,445,3.8,40,13,2,8,14,77,3.74025974025974
8oVuCgY36DBA78kz6YcvMg,The Franklin Room,41.8944615442319,-87.6355194300413,2,87,56,20,12,5,180,4.155555555555556,5,4,0,1,0,10,4.3
oT7oYmyGKFdBk0IkuNZG0A,Mity Nice Bar & Grill,41.898125,-87.624,2,82,131,46,23,6,288,3.9027777777777777,23,11,2,1,3,40,4.25
p_tOKdAg5rlyVYRCkmVPCA,Chicken Planet,41.87731,-87.633287,1,55,28,6,4,0,93,4.440860215053763,5,2,1,0,0,8,4.5
Kx9pLt4R4xidSYp0O6eYIg,Frontier,41.901201,-87.663558,2,129,194,122,80,72,597,3.3819095477386933,16,12,5,11,35,79,2.5316455696202533
UHpF_srjnjY4qON4rRmNhw,Catalpa Kitchen,41.928899,-87.697698,2,22,13,3,11,10,59,3.440677966101695,7,1,0,1,1,10,4.2
KFNk35nSCX8IRum2aJdRag,El Nandu Restaurant,41.9245679,-87.6962445,2,87,111,56,16,11,281,3.8790035587188614,21,13,6,4,3,47,3.9574468085106385
Ykp_iKvHJ_pTI82dZz1-3Q,Fish N Go,41.9678492,-87.7279203,1,31,14,2,0,2,49,4.469387755102041,6,0,0,1,1,8,4.125
YGeWhWTczkcVkyBjhtNu0Q,New Rebozo Chicago,41.8958387794489,-87.6263744324445,2,110,51,16,10,12,199,4.190954773869347,16,4,1,1,0,22,4.590909090909091
z7OThcftCn9VDAS1_Q25mw,Analogue,41.927355,-87.704059,2,66,75,26,15,6,188,3.9574468085106385,7,1,3,2,1,14,3.7857142857142856
D6MWQfG-roA9XOJzZpeSzQ,Coco’s Famous Deep Fried Lobster,41.8762618,-87.6309014,2,19,22,10,2,3,56,3.9285714285714284,4,1,0,0,0,5,4.8
uM0bo8IaXddPZlIYfDSHhQ,Miss Ricky’s,41.8859721645609,-87.6261784748899,2,54,28,21,7,6,116,4.008620689655173,7,1,0,1,1,10,4.2
Isk24q9-8UKvmRnqq9sI1w,Cafe Monsivais,41.8576885,-87.6676494,2,24,5,0,1,0,30,4.733333333333333,3,1,0,0,1,5,4.0
nXf_dI4UysHdiHSGfOAxgw,Olive Mediterranean Grill,41.9104919433594,-87.6533966064453,1,66,55,15,16,6,158,4.006329113924051,16,3,3,0,3,25,4.16
OjxC2nBsMtJ823svgxNidA,Meatball Hero & Pasta,41.9373997527714,-87.6485764235258,1,23,7,0,1,1,32,4.5625,6,1,0,0,1,8,4.375
t5ITATMeEW0bgFniS053Vg,Falafel & Grill,41.9058784,-87.6701601,1,117,86,19,13,16,251,4.095617529880478,20,0,2,3,2,27,4.222222222222222
Rm_EofhjiLzRJpUuVtPxUw,Breakfast House,41.8909301757812,-87.6721038818359,2,69,46,11,6,4,136,4.25,11,3,0,0,0,14,4.785714285714286
sJOPkTGLi53eB46ykvDeRg,Farm Bar Lakeview,41.9363489,-87.6613836,2,20,17,3,1,2,43,4.209302325581396,2,1,0,0,0,3,4.666666666666667
5m4v-Gs7y6f0MjrYVsrYrA,The Bedford,41.9035195,-87.6680886,2,145,197,125,60,27,554,3.6732851985559565,27,8,5,4,16,60,3.433333333333333
PCm3wmXQz-2LzWN2jaHOAg,Mista,41.9356263,-87.6441215,1,134,121,26,14,9,304,4.1743421052631575,22,14,3,2,1,42,4.285714285714286
U2YXXjZVLzKDnUTIRlmE4w,Red Door,41.9201776000927,-87.6778507232666,2,97,103,58,31,32,321,3.629283489096573,15,2,3,2,11,33,3.242424242424242
7erf6yRfYGkrQAuLo9e9xA,Schubas,41.9396448,-87.6633576,2,134,137,34,12,7,324,4.169753086419753,25,16,3,1,1,46,4.369565217391305
sjhBzCcFE2bzAG3j53roZQ,Toro Sushi,41.92876,-87.64253,2,488,254,104,42,30,918,4.228758169934641,93,41,13,6,30,183,3.879781420765027
TP8zxYve1T4_xq7mLAT-1g,Ceres Cafe,41.8780574,-87.6322115,2,97,119,51,12,11,290,3.962068965517241,15,7,2,0,5,29,3.9310344827586206
nTfySYjeLQ4jvy3jyImgPg,Nellie’s,41.9032989,-87.689329,2,82,64,24,13,14,197,3.949238578680203,8,10,2,6,3,29,3.4827586206896552
kmTa3vsoc9TskIJXUaq9Sg,Smack Dab!,42.0093092,-87.6662575,1,34,2,1,1,0,38,4.815789473684211,2,0,0,0,0,2,5.0
1ujpo6di-VHGmf1kZnRtpQ,Cochon Volant,41.8807911918252,-87.6310143247247,2,64,50,27,19,6,166,3.8855421686746987,28,5,0,0,20,53,3.3962264150943398
YbLA3uRpvBzIf4oJ352ZVQ,Ada Street,41.9124417,-87.6624316,3,204,98,33,17,14,366,4.259562841530054,27,3,3,1,1,35,4.542857142857143
vz1aN17saAgwhRD8kneCGw,The Roost Carolina Kitchen,41.954304,-87.6667421,1,216,106,31,26,12,391,4.248081841432225,21,5,3,0,1,30,4.5
BShJp9xl8EzP55v6Ix1yxw,M2 Cafe,41.8781528,-87.6494583,1,28,19,4,1,0,52,4.423076923076923,3,1,0,0,1,5,4.0
gGnXdeIA6mox_qN0NK51AA,Pl-zen,41.8576037,-87.6645281,2,94,64,20,16,17,211,3.957345971563981,19,5,1,1,2,28,4.357142857142857
nWrCnzpYMM6iUu7z5dpKHQ,mEAT Streeterville,41.8981469,-87.6212523,2,81,63,30,26,17,217,3.76036866359447,7,2,0,1,5,15,3.3333333333333335
M_sh3GHNCE18tRk3HSSPgw,KICK,41.9523277,-87.6777054,2,16,7,6,6,0,35,3.942857142857143,3,2,0,0,0,5,4.6
lPnav884H0DxHrftYF1BIg,Shilas Restaurant,41.952728,-87.747679,1,64,28,5,3,10,110,4.209090909090909,3,2,0,0,0,5,4.6
HkUUKDwlIu869ECubV4NfA,Tanta,41.8917256,-87.6319254,3,262,158,58,33,8,519,4.219653179190751,37,6,6,6,2,57,4.228070175438597
uedthTjMF_sesLM3AHWPKg,Bar Marta,41.895968,-87.694404,2,21,6,7,0,0,34,4.411764705882353,2,0,0,0,0,2,5.0
-sdMTRmgExufOk6STZFi9w,Little Goat,41.8846774003408,-87.6484838801892,2,913,817,326,180,67,2303,4.011289622231872,89,43,29,18,50,229,3.449781659388646
cuGkFLdPWfFX9hm2bcBHkQ,Twin Anchors Restaurant & Tavern,41.912687,-87.638328,2,218,195,63,42,24,542,3.9981549815498156,52,18,9,5,5,89,4.202247191011236
O5DxHwAON5jvAplwAYUAww,Tom Yum Cafe,41.9380183,-87.644581,1,35,11,5,4,2,57,4.280701754385965,2,0,0,0,0,2,5.0
oxJFCIVL9oQcmSIVSOBYew,Taco el Jalisciense,41.8955552684926,-87.6992754441786,1,48,22,4,8,4,86,4.186046511627907,10,1,1,0,1,13,4.461538461538462
VCk0JKBSshi5bolPoPMA7g,El Picosito Jibaro,41.96872,-87.70922,1,18,4,2,1,1,26,4.423076923076923,1,0,0,0,0,1,5.0
Sx6QrEqlOb9qxzajR2nymQ,Taqueria Los Comales 3,41.8579419,-87.6655351,1,65,73,36,11,7,192,3.9270833333333335,10,7,3,1,0,21,4.238095238095238
d1_U0mQp4UtGvQ-jKymSjA,Iguana Café,41.8918134,-87.6473434,1,205,212,66,26,16,525,4.074285714285714,45,18,4,3,2,72,4.402777777777778
kysa2NqoR8iYIjuaWELeZA,Nhu Lan Bakery,41.9687353,-87.6944679,1,421,163,39,14,7,644,4.517080745341615,43,24,6,3,6,82,4.158536585365853
gSMAmIma0SWC0qJnZeggnA,Café Iberico,41.896559,-87.6323,2,471,713,289,181,77,1731,3.7625649913344885,107,81,39,13,39,279,3.7311827956989245
zVJGZSkex8xcjcQYq96AGw,Three Aces,41.8693015,-87.6601878,2,215,250,84,42,42,633,3.8751974723538702,24,12,8,11,8,63,3.5238095238095237
sVhBjFA3Tspe76vI2Qx8YA,Green Apple PHOever,41.8818416049609,-87.6311031728983,1,35,60,17,9,6,127,3.858267716535433,7,3,0,1,0,11,4.454545454545454
6A9y89LPWaSSTnTx6spACw,Tacos Tequilas,41.934495,-87.71571,2,98,42,13,22,16,191,3.9633507853403143,16,5,4,3,3,31,3.903225806451613
UBRUh0001F5MbeziBV-BFw,Range,41.921427,-87.656728,2,63,49,17,15,4,148,4.027027027027027,11,4,2,1,0,18,4.388888888888889
l5hXXbHvNBe_5zGPGy12Ig,de Quay,41.926793,-87.651114,3,69,22,4,0,1,96,4.645833333333333,2,1,1,0,0,4,4.25
mr3AfxQq0vvXi9u4GWKGQQ,Taco & Burrito Palace,41.9457099,-87.6491673,1,47,45,14,8,2,116,4.094827586206897,7,4,0,0,4,15,3.6666666666666665
9qeOkQ83dyFylyW1Wknaog,Bohemian House {BoHo},41.890643,-87.6284979,3,268,93,20,7,5,393,4.557251908396947,15,3,1,0,1,20,4.55
jJ0h_gQ7EMM1on27-xae0A,Square Bar & Grill,41.9391564,-87.6997392,2,122,173,44,25,15,379,3.955145118733509,25,18,2,1,10,56,3.8392857142857144
hvHVAs2lhaoYo_rxOUuSTQ,La Villa,41.9474961,-87.7275922,2,157,117,54,14,25,367,4.0,59,16,7,6,36,124,3.4516129032258065
Kf7-C4keQtiv5ir6pSFkuw,Soupbox,41.8967091,-87.6264223,1,162,231,90,44,17,544,3.8768382352941178,23,14,8,2,4,51,3.980392156862745
nRnrKX7vMf71BknQdCM-cQ,La Cocina Boricua de la Familia Galarza,41.9251843,-87.6885235,1,120,71,18,8,4,221,4.334841628959276,20,6,1,0,2,29,4.448275862068965
nTL9tlTqGr5-J68W-3Szww,Taqueria Traspasada,41.8964184,-87.6670774,1,127,89,26,12,9,263,4.190114068441065,37,15,4,2,3,61,4.327868852459017
bg20bWGO5cD7A873sEb9kw,Silom 12,41.9150115,-87.6847531,2,88,119,40,27,10,284,3.8732394366197185,11,10,4,1,5,31,3.6774193548387095
eSJmeMaFydm1_UM57RiV4g,Pomp & Circumstance,41.907796,-87.634775,2,25,14,20,5,7,71,3.6338028169014085,7,1,2,1,2,13,3.769230769230769
LfQ1uwVQaUIgRENAZUz_1w,Fish Bar,41.9360951,-87.6539928,2,242,237,144,67,26,716,3.840782122905028,23,23,10,5,9,70,3.657142857142857
f1P5hZSitUEAC-mtXlBB7w,Del Seoul,41.9295395,-87.6428352,1,592,606,178,30,16,1422,4.215189873417722,61,37,10,6,7,121,4.148760330578512
3I_t76gJLU6w6YD_yoEkZQ,Vera,41.885376,-87.653188,3,78,84,32,18,14,226,3.8584070796460175,8,6,0,6,1,21,3.6666666666666665
K9PR2ixP1in-sqiQN-kinA,Gio’s Cafe and Deli,41.8436724,-87.6429957,2,102,61,17,8,8,196,4.229591836734694,16,5,1,1,4,27,4.037037037037037
uyUKtGWLYgu-RLjlNImy0A,Tango Sur,41.9507672,-87.6639827,2,692,569,165,155,99,1680,3.9523809523809526,116,69,15,14,46,260,3.75
kvAYT2J3pSXAip1B-06rJA,De Noche Mexicana,41.9303748868813,-87.7099578133012,2,91,78,22,14,4,209,4.138755980861244,9,7,0,1,4,21,3.761904761904762
1V70yrdGPyfpM-uuXK9xag,Aquitaine,41.9225373376761,-87.6444169449997,2,50,66,26,12,12,166,3.783132530120482,12,3,3,2,3,23,3.8260869565217392
OEHnRYfv0E0JaJhMh-TpMQ,Burger Bar Chicago - Lincoln Park,41.9101921,-87.6489023,2,239,324,125,70,31,789,3.849176172370089,38,25,12,7,8,90,3.8666666666666667
2LLApMHFO88KvxaM8emM_w,Mr D’s Shish-Kabobs,41.9310996,-87.7928557,1,62,12,3,0,1,78,4.717948717948718,13,3,0,0,1,17,4.588235294117647
OSOGRBCmY2QxC6ghsSQijg,Shawarma Inn,41.9824495,-87.693256,2,100,40,20,12,14,186,4.075268817204301,24,11,4,0,8,47,3.9148936170212765
fZQZYEwLhA0gjG-51VyfLQ,Blue Street Market,41.8808,-87.6279,1,12,4,2,0,0,18,4.555555555555555,2,0,0,0,0,2,5.0
iXuCIziS010a65NGGIiEhw,Taste of Perú,42.00133,-87.671331,2,209,128,38,17,22,414,4.171497584541063,53,15,5,2,6,81,4.320987654320987
MPWQAGiEqvnI8uxzJFND8w,The Monkey’s Paw,41.927818,-87.663743,2,65,61,22,14,2,164,4.054878048780488,14,6,1,1,0,22,4.5
2kcrnjcmvPgUTqs3m5My8Q,Son of a Butcher Tavern,41.9322609,-87.701483,2,27,16,7,8,7,65,3.7384615384615385,5,0,0,0,0,5,5.0
VhScSsvXZl6J7j1Vat7ccw,Jarabe- Mexican Street Food,41.8688604,-87.6833362,1,41,7,2,1,1,52,4.653846153846154,4,0,0,0,0,4,5.0
XZZxkzQ9esWKWxyG3yYatg,La Storia,41.9034579,-87.6302709,3,11,7,1,1,0,20,4.4,1,0,0,0,0,1,5.0
IwgIbrT1RYh_gy-JUGiHjg,Tarantino’s,41.9182634,-87.6559988,2,47,59,14,11,7,138,3.927536231884058,9,3,0,1,1,14,4.285714285714286
LOwInnfIfVFXpzaFYnrsnw,Flo,41.8963619,-87.6639483,2,257,264,102,43,17,683,4.026354319180088,37,18,2,1,6,64,4.234375
YqzDH4OmV43NeD1h4yu7Tg,Kabobi Grill,41.9676084816456,-87.7085164189339,2,103,41,9,11,8,172,4.27906976744186,20,1,3,0,0,24,4.708333333333333
jGiKIJCVLZHXQDSNnSLPsw,Xoco,41.8907114,-87.6309164,2,1179,1053,401,181,56,2870,4.086411149825784,210,139,47,33,98,527,3.6261859582542693
xBH5KMc4AC_epHM1n0Uc5g,Red June,41.9183014,-87.6827188,1,57,52,13,5,4,131,4.1679389312977095,6,2,1,3,2,14,3.5
5n86ysWVnN9SUA-VUVctrQ,Manny’s,41.867936029135,-87.642088208016,2,309,175,77,37,29,627,4.113237639553429,41,26,3,16,15,101,3.613861386138614
V14IpoI-vKw3i_a_waSQrw,Gogi,41.995146,-87.699895,2,77,53,20,4,11,165,4.096969696969697,9,7,0,1,0,17,4.411764705882353
I4R5Zs7whwQf29XhQ_RaBA,Chez Moi,41.920093536377,-87.6487808227539,2,88,76,28,20,10,222,3.954954954954955,27,6,2,6,4,45,4.022222222222222
gbnabQiEgwrlcZbhFkOkNw,Publican Quality Meats,41.8866401069567,-87.648562335968,2,230,129,28,23,12,422,4.2843601895734595,15,9,1,1,2,28,4.214285714285714
TpRzi_TaFkaN2toazG72wg,Scafuri Bakery,41.8692659,-87.6606725,1,79,27,5,2,5,118,4.466101694915254,21,2,0,0,0,23,4.913043478260869
n6unwNuq-_KCyHi0JspBiA,Kuma’s Too,41.9328803,-87.6461683,2,182,176,102,107,68,635,3.467716535433071,21,14,13,16,20,84,3.0
4LRC9kedY535bIBpqyBWdw,Chilam Balam,41.9372476,-87.6441799,2,193,181,77,73,41,565,3.729203539823009,26,15,3,14,28,86,2.9651162790697674
vx8FYc1aKtf8TyhH8-qipA,Tandoor Char House,41.930648,-87.649284,2,258,109,50,29,28,474,4.139240506329114,39,15,2,5,7,68,4.088235294117647
WBU0yq9J8qiYQfI_fh2P1Q,Crisp,41.9357676,-87.6442781,2,905,696,162,73,37,1873,4.259476775226909,124,57,12,14,27,234,4.012820512820513
f4fD6idENn2dfamJLxAYYA,Francesca’s Cafe,41.897537,-87.6773969,1,19,9,0,1,0,29,4.586206896551724,6,1,0,0,0,7,4.857142857142857
B4BaXk9lRHeThRZ60yjArQ,Nick’s On North,41.9098029,-87.71031,1,33,11,1,0,0,45,4.711111111111111,40,3,0,0,0,43,4.930232558139535
VnoltTUAEhtmTCe0XCGYCQ,Compass Bar,41.9325819,-87.640763,2,52,31,7,8,4,102,4.166666666666667,7,1,0,0,1,9,4.444444444444445
I8W5EBWP5ajd1tk8IwhRfg,The Rosebud,41.869524,-87.664293,2,147,152,62,32,19,412,3.912621359223301,26,20,4,5,10,65,3.723076923076923
VikWqZa32i70Qp-ETzw_lw,Hugo’s Frog Bar & Fish House,41.901191,-87.627793,3,283,263,67,45,21,679,4.092783505154639,39,40,13,4,8,104,3.9423076923076925
cx4CJLlDqcjDJb1ec9pFPQ,Tabaq Restaurant,41.904828,-87.640538,1,39,27,4,4,0,74,4.364864864864865,6,7,1,1,5,20,3.4
AqgG-1aD6JYj9D6OmBWO3w,Frontera Grill,41.8905699,-87.630795,3,662,521,241,146,72,1642,3.9470158343483557,65,49,30,42,65,251,3.0278884462151394
4OF7gij3pj8f-haNC-WLqA,Nando’s Peri-Peri,41.93303,-87.64639,2,43,26,17,11,6,103,3.8640776699029127,3,2,1,0,3,9,3.2222222222222223
JSw23BvU6mF-6S02d5ijBA,Señor Pan,41.9246876,-87.7421982,1,179,97,30,16,13,335,4.232835820895523,44,15,3,4,4,70,4.3
sfWMOqUEp8S2adDeJp7Kzg,Carnivale,41.887075681459,-87.646048728271,3,515,610,253,131,57,1566,3.8908045977011496,86,76,28,11,35,236,3.707627118644068
npBBFxQsJEccu7ZRafVv8Q,Blaze Fast-Fire’d Pizza,41.9398005272759,-87.6535915442469,1,123,80,22,6,3,234,4.3418803418803416,10,6,0,4,1,21,3.9523809523809526
CSxbbmY-OshnCG7GZ062Ww,The Roost Carolina Kitchen,41.8902896,-87.6459801,2,31,11,7,5,1,55,4.2,2,0,0,1,2,5,2.8
XvP-kanjF6SpchosRk0N5g,Tacos Garcias,41.9173295,-87.7115566,1,19,18,3,4,1,45,4.111111111111111,0,5,0,0,0,5,4.0
8n2XXdE8yABKRqcDLURStw,The General,41.92737846759,-87.6976759119732,2,30,18,6,12,2,68,3.911764705882353,7,1,0,0,0,8,4.875
fFX6L_QDexlgoYoCigJyPw,Canton Regio,41.857996,-87.6642384,2,17,0,3,0,1,21,4.523809523809524,3,0,0,0,2,5,3.4
jA9n0blJbyaP1pcmn0yu2A,J.P. Graziano Grocery Co.,41.884054,-87.650012,1,228,75,22,2,3,330,4.584848484848485,40,13,0,2,0,55,4.654545454545454
jrwI3Z6s3k7MdDWn8udnag,Cafe Versailles,41.9556287,-87.7276826,1,156,28,7,4,3,198,4.666666666666667,35,5,0,1,0,41,4.804878048780488
_wtMT97gelNAyfI82FPFvA,3 Arts Club Cafe,41.9059904,-87.630489,2,40,27,2,2,6,77,4.207792207792208,2,1,0,0,1,4,3.75
ALS176JmkzhXLwas4_PmfQ,Afghan Kabob,41.9610735,-87.7294715,2,121,66,12,6,5,210,4.390476190476191,30,10,4,0,0,44,4.590909090909091
3BKnY2wzy4QM20Fr1nqDsg,Flo & Santos,41.8654554,-87.6262023,2,165,245,83,43,27,563,3.8490230905861456,26,15,5,6,10,62,3.661290322580645
V3_UIvTZGIOMFM93LZF9TA,Laschet’s Inn,41.9538129,-87.6819809,2,211,111,29,10,7,368,4.383152173913044,20,10,2,2,5,39,3.9743589743589745
phBeeW6_yDFs7aIeNssNsQ,JP Burke’s Patio & Tap,41.934864,-87.661502,2,32,8,3,4,3,50,4.24,1,0,0,0,0,1,5.0
m_w5UfOmgAqN4Kgbl_-iFQ,Siam Noodle and Rice,41.967092,-87.6552201,1,177,101,37,12,16,343,4.198250728862973,16,9,5,0,1,31,4.258064516129032
OcMQUx_fyrUQdWwtnfuofw,The Matchbox,41.8955861,-87.6548113,2,110,97,21,8,5,241,4.240663900414938,15,5,3,1,4,28,3.9285714285714284
rvKhV_bht0WAJ2V-C85Ugw,Woodhaven Bar and Kitchen,41.895272,-87.631586,2,15,6,3,3,2,29,4.0,1,1,0,0,0,2,4.5
Jiy1hhSmoibJqZCzdFxEog,Mana Food Bar,41.9035572,-87.6717315,2,409,258,86,35,19,807,4.242874845105328,48,24,10,9,18,109,3.688073394495413
LYppbvgJlBG0SqjSKFiFGg,Sapori Trattoria,41.9316531,-87.6486055,2,779,396,148,50,14,1387,4.352559480894016,156,51,13,14,21,255,4.203921568627451
nX0eoQLMANnKZAQbB_1vxw,Roti Mediterranean Grill,41.8812381,-87.6391393,1,57,103,45,16,5,226,3.8451327433628317,9,13,5,3,24,54,2.6296296296296298
1g52-6WzlhjIOpNAsBjPJg,Sushi X,41.896362,-87.656584,2,151,138,48,26,16,379,4.007915567282322,48,19,2,4,6,79,4.253164556962025
sWaqKAhrbCkpO7iJQ9p7cA,La Catrina Cafe,41.8578854,-87.6520282,1,29,25,13,3,1,71,4.098591549295775,4,3,1,2,0,10,3.9
CW4FFPxrORdWqISWH9HzmQ,Ge Pa De Caffe,41.8797307542628,-87.6254783645339,1,151,39,12,7,5,214,4.514018691588785,14,2,0,0,1,17,4.647058823529412
unEyk5htv8K18lh-tQIE6w,Punta Cana Restaurant,41.921122,-87.7122916,1,21,14,0,0,0,35,4.6,3,1,1,0,0,5,4.4
_P_lfN9VfzlmDjDKo2gXZQ,Cafe Jumping Bean,41.85762,-87.6627682,1,118,75,23,9,6,231,4.255411255411255,24,16,2,1,5,48,4.104166666666667
XFdDRzpkDhzQtxiD3JJutw,Black Iron Tavern,41.8893808,-87.6445138,2,29,2,4,5,4,44,4.068181818181818,4,1,0,0,0,5,4.8
yYAJAUfqnN3rQw7S8Cj12Q,Brightwok Kitchen,41.8793135,-87.6267721,1,102,20,12,3,1,138,4.586956521739131,9,1,0,0,0,10,4.9
axy7lu2io6Xn4KvEBsxckg,The Eastman Egg Company,41.8827071785927,-87.6367197185755,1,50,31,4,9,4,98,4.163265306122449,4,1,0,0,0,5,4.8
3o0WB9KL91neiy_rlDhxyg,Devil Dawgs,41.872102,-87.627098,1,90,78,23,17,9,217,4.027649769585254,8,3,2,1,4,18,3.5555555555555554
Ykiz1UT9SO5u-y8nqDTy4A,Fork,41.9651141,-87.6864322,2,230,285,110,70,38,733,3.8171896316507503,47,20,6,9,34,116,3.3189655172413794
O12QxTwfeeavxVx2uKjBlw,Earls Kitchen + Bar,41.9086332515198,-87.6474467969988,2,42,18,10,2,3,75,4.253333333333333,0,5,1,0,1,7,3.4285714285714284
LOP-C_rM4uFK1_833lB22A,Johnny’s Beef & Gyros,41.9237286606847,-87.6465864306884,1,45,8,7,6,5,71,4.154929577464789,24,2,0,0,0,26,4.923076923076923
k5f-N-Oh64tivQiti_pkDQ,FTW Chicago,41.8913221,-87.6189949,2,17,26,5,3,8,59,3.694915254237288,3,0,1,0,2,6,3.3333333333333335
MqB2og2Bdv0YcztieKEWjg,BarTucci,41.9423672,-87.8069085,2,39,9,1,2,3,54,4.462962962962963,7,1,1,1,0,10,4.4
Jnaatj70xLwtHrrYQXCr7A,Wise Owl Drinkery & Cookhouse,41.8767083604545,-87.6571454693116,2,33,16,5,8,3,65,4.046153846153846,9,1,0,0,0,10,4.9
At8ihucEIROkH2uDY6OGtQ,Pleasant House Bakery,41.8380794,-87.6512529,2,254,139,38,11,6,448,4.392857142857143,28,16,1,3,2,50,4.3
2HCUc0_ALwpoyrZjblrg5A,Pinstripes,41.8907956212089,-87.6165341842676,2,77,49,21,11,8,166,4.0602409638554215,10,5,2,0,2,19,4.105263157894737
MzLH4VUPIDf16LUPlPzaGg,Zia’s Lago Vista,41.9513156,-87.6685576,2,134,63,19,22,9,247,4.178137651821863,13,2,1,3,0,19,4.315789473684211
dKcO9OQ44RPRlkWe-vToFA,Shaw’s Crab House,41.8899505,-87.6271084,3,634,451,158,65,37,1345,4.174721189591078,91,65,13,12,36,217,3.751152073732719
KBl9QR4iVzT_4rF7FzTdyg,GT Fish & Oyster,41.8917901,-87.633925,3,449,405,150,59,24,1087,4.100275988960441,51,41,20,14,9,135,3.8222222222222224
9mhqcimD0CYvqxzfj_VXnQ,Little Bad Wolf,41.9833527,-87.6690636,2,241,106,31,8,1,387,4.493540051679586,22,9,1,0,2,34,4.4411764705882355
H35F7d6Pffd8TNw1VU3myQ,Glazed & Infused,41.8902311,-87.6276247,1,125,93,36,14,9,277,4.122743682310469,8,3,1,0,1,13,4.3076923076923075
KKVTpvVr2nxw8zg_nH8lmg,Grill & Garden Restaurant,41.9785615115321,-87.660001963377,1,30,5,2,2,2,41,4.439024390243903,5,2,0,0,1,8,4.25
RjekqT6Mfg1XjQtLtgqtvg,Diez Y Ocho,41.8578431,-87.6761481,2,43,14,6,4,6,73,4.1506849315068495,8,1,0,0,1,10,4.5
ZcGuLKfgZAWuhMBbfqXBmw,Taqueria El Asadero,41.9612716,-87.6843339,1,174,124,25,27,14,364,4.145604395604396,30,9,4,1,3,47,4.319148936170213
D-fAPWkLhe41j4rHGRZgIQ,La Fournette,41.9105233,-87.6343456,2,168,93,35,11,8,315,4.276190476190476,8,14,0,1,2,25,4.0
MwobGG_QI3QLf5HencV3Yg,The Kitchen Chicago,41.887871,-87.631234,3,83,64,23,16,6,192,4.052083333333333,5,1,3,0,0,9,4.222222222222222
r2eRY7UymHkcopNgzjJv9g,Esencia Urban Kitchen,41.9432065013836,-87.6445358158359,2,52,40,10,3,4,109,4.220183486238532,5,2,0,0,1,8,4.25
tCBKjclvCuiuSkiNz1fOjw,Wood,41.942829280388,-87.649184667136,2,147,71,34,31,21,304,3.960526315789474,41,9,1,5,7,63,4.142857142857143
FjuWa978SmBM4lrSmJgePw,Spotted Monkey,41.8770473,-87.6347976,2,16,4,2,0,1,23,4.478260869565218,0,0,0,0,0,0,x
HSfjGxJ_XcA03eQJ9uniYw,Trike,41.927624,-87.704557,2,39,45,15,9,6,114,3.8947368421052633,4,3,1,1,0,9,4.111111111111111
U9D0vqEP4QrJfJYs8mr3DA,Oiistar,41.9070880100627,-87.6720839738846,2,164,208,115,36,21,544,3.8419117647058822,26,9,0,3,3,41,4.2682926829268295
ed3NV3_-A8B1_w0_oCFpWQ,Bite Cafe,41.9004625,-87.6866398,2,251,277,100,44,30,702,3.9615384615384617,30,25,4,10,21,90,3.3666666666666667
9AXJmehEJ3hZqL2lmLeP5Q,Nando’s PERi-PERi,41.9082411,-87.646727,2,15,11,3,2,3,34,3.9705882352941178,1,1,0,1,0,3,3.6666666666666665
NkiMNg57iKeBLRdt9jv2Aw,The Boarding House,41.8946762084961,-87.6342620849609,3,141,156,97,43,13,450,3.82,18,9,9,18,31,85,2.588235294117647
1kySpL0s7cdFRHD8XbsonA,Chicken Works & Salad Company,41.9538116,-87.7198351,1,70,69,14,10,5,168,4.125,15,9,0,0,1,25,4.48
tE9iDf1UZWIEeSu3RYbizg,Koko’s Mediterranean Grille,41.8962001,-87.6720127,1,34,13,6,3,5,61,4.114754098360656,4,0,0,0,0,4,5.0
Au1f1UMmKcgOXLsg4v56xw,Little Bucharest Bistro,41.9479987,-87.7105289,2,197,70,28,15,24,334,4.200598802395209,75,14,3,11,16,119,4.016806722689076
orZRAjCMGQrNsoshGAwDkA,Red Hot Ranch,41.9375348836184,-87.6685266941786,1,49,21,3,2,5,80,4.3375,6,0,0,0,0,6,5.0
lSrO-tXH3jR9HODPzft9OQ,Jimmy’s Red Hots,41.906653,-87.726735,1,112,49,22,8,9,200,4.235,28,12,3,0,4,47,4.276595744680851
7HQy7afYxXg5pYUa9G_Hkw,City Cafe,41.9406547546387,-87.7270050048828,1,22,10,4,1,3,40,4.175,3,1,0,0,0,4,4.75
qTWNOtzb4H0DIkUrHX1_8Q,Sauce And Bread Kitchen,41.9975261,-87.6705616,1,46,18,2,1,0,67,4.626865671641791,2,1,1,0,0,4,4.25
_StOUGMGMmENR44zAEoDrA,Big Star,41.909228215006,-87.677153784986,2,557,922,450,239,179,2347,3.6131231359181935,86,108,44,54,103,395,3.050632911392405
AUD5KF5YvKY-5yf_qH8UJg,The Spanish Square,41.940031,-87.663441,2,16,4,3,0,1,24,4.416666666666667,3,0,0,1,0,4,4.25
ALwH81_sqskLmwfWS-_eeQ,Tank Noodle Restaurant,41.9731009,-87.6594002,1,358,566,201,78,75,1278,3.8247261345852896,49,39,17,14,17,136,3.6544117647058822
PCfWAWgdt3iDiTaUNUkygQ,White Oak Tavern & Inn,41.9218608,-87.6584955,3,51,15,5,10,8,89,4.022471910112359,8,3,1,1,1,14,4.142857142857143
mTOxKyJfY7OgeS9jUa88ew,Pane Caldo,41.897992,-87.6252109,3,29,5,0,3,3,40,4.35,2,1,0,0,1,4,3.75
tTXXzotbAK9qcY3902oQ0w,Jane’s,41.9158184,-87.6699248,2,125,171,89,65,33,483,3.600414078674948,24,19,5,13,14,75,3.3466666666666667
TrHpyyurfCHWUQMpsLyxVw,Bari,41.8913526,-87.655624,1,387,139,44,22,8,600,4.458333333333333,78,30,4,5,31,148,3.804054054054054
He0Q7h8TWsh_BJt4FyJFzg,G & N The King Of Breakfast,41.9097335,-87.7529053,1,12,1,0,0,1,14,4.642857142857143,4,0,0,0,0,4,5.0
6nThdNoEuRfHwjNR875fVw,Feed,41.895473,-87.696973,1,203,189,69,44,15,520,4.001923076923077,19,14,1,4,3,41,4.024390243902439
Lw1Nz0Gus-RYJsg2Kk8dXw,Shawarma Garden,41.9030684,-87.6768271,1,54,27,10,9,3,103,4.165048543689321,9,3,0,1,2,15,4.066666666666666
sOaAqqEeJFX8BJ5epsoGcg,Kingsbury Street Cafe,41.9087751,-87.6522372,2,95,134,36,24,14,303,3.897689768976898,11,8,1,2,0,22,4.2727272727272725
yfG_KkZNW0Ku5VzgNe5AdQ,Opart Thai House,41.895924159886,-87.6621551066637,2,18,3,2,1,0,24,4.583333333333333,0,0,0,0,0,0,x
5p1qUSpK5XcIU2tGFYollA,American Wildburger,41.904607,-87.6484441,2,28,6,1,1,3,39,4.410256410256411,4,1,0,0,0,5,4.8
O75seiu0VjzefAyr6dqpTg,Sink | Swim,41.9171625,-87.707679,3,28,32,15,14,3,92,3.739130434782609,0,0,0,1,1,2,1.5
p_H2BANrAWEZbSyqmnviSQ,Uncle Mike’s Place,41.8910594,-87.6699379,2,174,154,45,23,8,404,4.146039603960396,16,13,2,2,3,36,4.027777777777778
KMgdD5KzGxysP9xvIte-rw,Henry’s,41.890442,-87.628757,2,101,60,18,7,9,195,4.2153846153846155,7,0,3,0,1,11,4.090909090909091
n2CRjfC5AjhzdcCd5vdH7Q,Via Lima,41.954775,-87.679563,3,26,11,7,7,2,53,3.981132075471698,2,0,0,3,0,5,3.2
p2cCK4Vu-3L-skOMd93VVg,JJ Thai Street Food,41.8958251,-87.6703764,2,40,17,5,4,0,66,4.409090909090909,1,0,0,0,0,1,5.0
yD1aRxezQ8XjrKogEfuShw,Susie’s Noon Hour Grill,42.0075552249299,-87.6662723055139,1,112,46,13,3,5,179,4.435754189944134,18,5,0,0,1,24,4.625
2TyiepxLggw8Zo6-oIDZ2w,JK Kabab House,41.9980104,-87.6949719,1,47,23,5,2,2,79,4.405063291139241,17,5,0,2,1,25,4.4
AO83FW-KEkwzxC0YcvGO1w,Osaka Sushi Express & Fresh Fruit Smoothies,41.876943,-87.624532,1,101,128,48,17,8,302,3.9834437086092715,21,10,4,1,4,40,4.075
-fYvsZKybtBorDlwxs9T1A,Dos Urban Cantina,41.9172562,-87.6984031,3,43,12,6,0,0,61,4.60655737704918,4,0,0,0,0,4,5.0
tL8lLGQaAnKb9I7a0vsGtg,Pizza Rustica Italian Bistro & Bar,41.9530511,-87.6547404,2,195,153,69,59,46,522,3.7509578544061304,33,15,8,10,20,86,3.36046511627907
ptRZlXxngjFj5gghwPNNHA,RJ Grunts,41.920024442085,-87.636636114155,2,199,264,111,59,20,653,3.8621745788667687,35,30,6,6,6,83,3.9879518072289155
e9aAISx0navH8qMr33X4TA,Mother Cluckers Kitchen,41.9752685744915,-87.7522482539673,2,136,58,15,5,4,218,4.454128440366972,26,7,0,0,2,35,4.571428571428571
qanlDj3Mom5PP1a-q4tVHA,Dunlays on Clark,41.9296741,-87.6434142,2,94,159,79,25,7,364,3.8461538461538463,15,12,5,12,3,47,3.5106382978723403
oCTlReyKjJxKPFYfCurxxQ,Lockdown Bar & Grill,41.90017,-87.687275,2,340,306,114,70,57,887,3.9041713641488163,71,29,8,13,44,165,3.4242424242424243
6udJ7FWw6QQKQyGadZoIXg,Groundswell Coffee Roasters,41.9700678,-87.6791949,1,44,5,2,0,0,51,4.823529411764706,2,2,0,0,0,4,4.5
wW5kd9bxJ4VJHtUYBbo7cQ,Urbanbelly,41.8843051046133,-87.6626251637936,2,87,82,43,23,10,245,3.869387755102041,5,6,2,1,0,14,4.071428571428571
4_D3FA4GoRCj6e_aG2DrQw,Naansense,41.8851056,-87.63391,1,105,87,37,18,22,269,3.87360594795539,9,4,2,2,2,19,3.8421052631578947
KwFp1p0t0L1CLCm4HSizsQ,Stella’s Diner,41.9377754,-87.6445297,1,196,233,68,32,21,550,4.001818181818182,39,26,7,7,27,106,3.4056603773584904
rL3Z28FBnl1tFXoIGPlgtw,Shake Shack,41.8927345,-87.6255937,2,157,241,175,104,31,708,3.5494350282485874,14,15,7,9,8,53,3.339622641509434
_AY9IeW20_FF5kON57rfZw,Haywood Tavern,41.899058,-87.6966343,2,37,9,5,4,2,57,4.315789473684211,2,0,0,0,1,3,3.6666666666666665
xNbjv2XaKt0ZATscozZsAg,Joy’s Noodles & Rice,41.941758,-87.644116,1,243,272,107,45,40,707,3.8953323903818955,47,47,6,13,10,123,3.8780487804878048
nj_Ophi8XsZLoQ0MfWnYiA,Kurah Mediterranean,41.8643253,-87.6237609,2,66,76,26,14,8,190,3.9368421052631577,17,3,2,1,3,26,4.153846153846154
CeIsnsESNIFzU2RClwqhLA,Ani,41.937143,-87.665649,2,44,34,10,4,2,94,4.212765957446808,4,2,0,0,2,8,3.75
pbEiXam9YJL3neCYHGwLUA,Alinea,41.913433,-87.648,4,1047,165,107,38,29,1386,4.5606060606060606,197,70,25,4,111,407,3.5847665847665846
hgB8EwFWzSZRJlUqvt1vRg,Black Rock Pub & Kitchen,41.9473859,-87.6787959,2,58,86,26,12,9,191,3.900523560209424,7,5,1,1,7,21,3.1904761904761907
baI-vvZjo-mliR62hdS1hg,El Maya,41.9618515883894,-87.6684951782227,2,92,33,8,4,6,143,4.405594405594406,7,6,0,0,0,13,4.538461538461538
p9TVco6JdcBxt_c_TtPcgw,Swift & Sons,41.887099,-87.6526547,3,49,14,15,9,2,89,4.112359550561798,3,0,0,0,0,3,5.0
O073WVgzIh5OXRVL9TrRFQ,BIG & little’s Restaurant,41.905356,-87.6700199,1,52,24,9,9,6,100,4.07,4,0,0,1,0,5,4.4
Ifk2tTefkmj9apIZOYyuBw,Will’s Northwoods Inn,41.93725,-87.6590293,1,111,74,23,6,1,215,4.339534883720931,13,4,0,1,0,18,4.611111111111111
LgpGgbUpykMz77byFujCWw,BIN 36,41.8850874,-87.6422767,2,58,23,9,7,13,110,3.963636363636364,15,3,0,0,0,18,4.833333333333333
4i1Ny2zIE1VJSU9gLMkHqg,Lula Cafe,41.927668036295,-87.706845233929,2,674,477,156,74,26,1407,4.2075337597725655,81,43,13,36,3,176,3.9261363636363638
cV85c42f61TNP9bRCYOUiA,Memo’s Hot Dogs,41.857612,-87.663135,1,14,3,0,0,0,17,4.823529411764706,1,1,0,0,0,2,4.5
CQ75CQSyrsmb-S3UAwCHpw,Wildfire,41.8938172904842,-87.6333183422685,3,306,308,106,65,23,808,4.001237623762377,69,42,7,12,18,148,3.891891891891892
rvodTVrLfaLk5q-MRlw7Nw,De Pasada,41.8690617,-87.6648395,1,60,60,22,11,14,167,3.844311377245509,19,5,4,1,0,29,4.448275862068965
s2FeNyxwxT7cMl_mS_ygFg,Osteria La Madia,41.8916287,-87.6302197,2,263,417,152,66,21,919,3.9085963003264417,36,29,10,15,18,108,3.462962962962963
N7F7C6ECkhbsHVStVjqLUw,Pasta Palazzo,41.9179075,-87.6488742,2,168,174,40,19,8,409,4.161369193154035,27,16,1,3,1,48,4.354166666666667
mXZS-Ue3awMfbMZLbaw72Q,Shokolad,41.8959276,-87.6904043,1,74,59,14,3,2,152,4.315789473684211,11,6,2,1,1,21,4.190476190476191
0eMo-MeawM-tmbwpzv3rDg,Carnitas Uruapan Restaurant,41.857612801225,-87.669703625051,1,72,29,4,2,5,112,4.4375,12,4,0,0,1,17,4.529411764705882
m5QcTnjCHFylTGDQJoqD4g,In-On Thai,41.9516763,-87.6496031,2,51,19,9,4,5,88,4.215909090909091,8,1,0,0,0,9,4.888888888888889
ooUICn2UHWsx_H7ioA55PQ,Take Me Out,41.858092,-87.663989,1,49,73,32,17,4,175,3.834285714285714,11,8,2,0,5,26,3.769230769230769
Nz7OSIHnWcsnno-zzXKO1g,The Allis,41.883746,-87.648281,2,57,45,12,13,10,137,3.9197080291970803,1,0,1,0,0,2,4.0
M-DKe6Zj5uCArHhYnvqTlg,Chez Delisay’s Cajun Cuisine,42.002352,-87.671711,2,65,9,0,0,0,74,4.878378378378378,3,1,0,0,0,4,4.75
bNXpwTSavHBV9zBk2lUlGA,Schwa,41.9089322,-87.6679279,4,266,55,29,22,37,409,4.200488997555012,62,12,6,3,41,124,3.411290322580645
wiNuegM8MNw9WIP0wfMmeA,Coalfire Pizza,41.8907946,-87.6598601,2,409,269,94,39,14,825,4.236363636363636,64,31,6,1,4,106,4.415094339622642
KXiClWndL6UyPJDt7y50zQ,La Scarola,41.891105990809,-87.646768416408,2,374,265,82,42,33,796,4.136934673366834,66,28,12,14,31,151,3.556291390728477
1qM4E_de9yotctnC2EP8kA,Cooper’s,41.940084,-87.660256,2,76,135,44,31,13,299,3.769230769230769,12,10,2,2,2,28,4.0
60qudKwZHT6-UijNbGVNWw,The Local Chicago,41.899394,-87.622297,2,117,91,41,31,16,296,3.885135135135135,15,4,1,1,2,23,4.260869565217392
y2YPhJsm4ZAOysBVy5k4pg,Rojo Gusano,41.9684246,-87.7245494,2,32,12,3,1,2,50,4.42,4,0,0,0,0,4,5.0
7Ig90WlrxTm-oLGt8AQrfQ,Enoteca Roma Ristorante,41.9033716,-87.6815757,2,133,138,48,27,18,364,3.9368131868131866,25,12,1,6,8,52,3.769230769230769
F2NBch93KPaQdM_x0Fs2VQ,Nini’s Deli,41.8923484,-87.6621932,1,221,34,10,3,2,270,4.737037037037037,42,6,1,0,1,50,4.76
0hfDRVaGSydijN5du1HCzg,Bar Siena,41.8845841437224,-87.6489488181068,2,131,82,44,21,17,295,3.9796610169491524,28,2,0,1,1,32,4.71875
0ZENqrACvQ4tiMvFEkgVPg,Jimmy’s Pizza Café,41.975763462268,-87.692168200781,1,168,111,31,21,9,340,4.2,18,12,2,3,0,35,4.285714285714286
7tNBi1bEcJ0LpLfllw6ZjQ,bellyQ,41.8844403,-87.6617991,3,164,179,110,66,22,541,3.733826247689464,19,15,10,10,4,58,3.603448275862069
nO8Yrt4l4JLSvCAkkwrk1Q,Gyu-Kaku Japanese BBQ,41.8927493,-87.6223086,2,400,372,110,44,35,961,4.100936524453694,40,45,7,8,27,127,3.4960629921259843
LPwAwxEjetjdNh7Uadro3g,Smoque BBQ,41.9502164,-87.7278658,2,1692,961,346,115,29,3143,4.327394209354121,445,213,42,26,72,798,4.169172932330827
Y9_O6IM2zRAXSvGVTkpyQQ,T & B Grill,41.9684336,-87.720522,1,112,20,3,0,0,135,4.807407407407408,4,1,0,0,0,5,4.8
8j97C2qR95tvpbGtoFxEAw,Noon O Kabab,41.966447,-87.708238,2,303,210,59,15,18,605,4.264462809917355,76,38,9,3,8,134,4.276119402985074
ksY97mbEy23n8GbYxOBgpA,25 Degrees,41.8959432,-87.6315927,2,207,233,80,31,22,573,3.9982547993019195,41,9,4,1,5,60,4.333333333333333
IBWaLosoL5Jop81u4FxFwA,Diner Grill,41.9540882,-87.6704891,1,88,63,25,9,10,195,4.076923076923077,13,4,1,0,4,22,4.0
tzP7xNT7OokI6JKgtINTlA,Antico,41.9174523,-87.6827936,3,80,39,7,4,1,131,4.473282442748092,16,7,2,0,1,26,4.423076923076923
HRGw4jttKMokp_PSGPhh8g,Nookies Edgewater,41.983679,-87.6581201,2,143,133,51,19,18,364,4.0,23,24,2,4,12,65,3.646153846153846
GzTF1V0GKPTPgh_xMg5ExA,Pork & Mindy’s,41.9110633,-87.6780882,2,41,9,5,15,3,73,3.958904109589041,2,0,0,0,0,2,5.0
U2i4dCWTP6AhSuCwDhhblA,Sinha Elegant Cuisine,41.8789233,-87.6774309,2,57,28,7,3,6,101,4.257425742574258,8,3,1,1,0,13,4.384615384615385
tDxyIlkRD-1_yrpv2-J-pA,Knife & Tine,41.924936,-87.664023,2,143,53,23,12,6,237,4.329113924050633,19,1,1,1,0,22,4.7272727272727275
MUmOoa2Zg2B2qBq1VHTNaA,Ban Po Chung,41.9759329,-87.7155875,2,76,60,15,9,5,165,4.16969696969697,7,4,1,2,1,15,3.933333333333333
OKOfoisduqP24uK3WYvx7Q,Revolution Brewing,41.92353,-87.698153,2,540,756,227,101,55,1679,3.9678379988088146,69,55,17,13,31,185,3.637837837837838
Gn43vOdPZ6JnN8dXhX9eyg,Carbon,41.8962405,-87.6686563,1,72,65,26,20,13,196,3.8316326530612246,12,5,1,1,8,27,3.4444444444444446
MrCu27MyX6wMTo43pjQ2wA,Northdown Café and Taproom,41.9408592,-87.6696507,2,121,84,35,16,12,268,4.067164179104478,13,7,0,1,5,26,3.8461538461538463
1CnmcCKb83Nkbdi1cZCCQA,mEAT,41.9428752,-87.6493312,2,74,37,16,19,14,160,3.8625,22,3,1,0,1,27,4.666666666666667
WgKaikMqCrevF8jXyTZ_mg,Cookies & Carnitas,41.9869847451742,-87.6598879952196,2,150,57,18,13,8,246,4.333333333333333,22,6,3,0,4,35,4.2
cTd7rc-cuJ8-xvJX-RPbUw,Pollo Express,41.8577196,-87.6595005,1,157,51,11,2,4,225,4.5777777777777775,31,9,1,1,3,45,4.4222222222222225
yFlwFrgmdSwrSBSqW8EBNw,La Cocina,41.933987,-87.707125,1,49,39,6,6,6,106,4.122641509433962,12,6,0,1,1,20,4.35
kyZQnv62VQnDk23i_TxO3g,Parachute,41.944707,-87.706518,3,108,55,39,29,9,240,3.933333333333333,7,3,0,2,0,12,4.25
fQCVQyUNAsDZmdjebXwY3Q,Sheffield’s Beer and Wine Garden,41.941574,-87.6545653,2,153,225,106,38,24,546,3.8150183150183152,30,16,2,4,6,58,4.0344827586206895
ZQ-k_wtaKB1tDNp9WtSMiw,Farmer’s Fridge,41.8860491,-87.6307076,1,38,13,3,3,2,59,4.389830508474576,7,1,0,0,0,8,4.875
50gFzdVglOz88eFJ6v-26A,Glenns Diner,41.9616270639775,-87.6754598194383,2,340,362,103,77,62,944,3.8908898305084745,50,35,13,22,76,196,2.8010204081632653
xFBQ1md6PDm7YEpJARoxAA,The VIG Chicago,41.909905,-87.6345048,2,24,12,7,4,2,49,4.061224489795919,2,0,0,0,1,3,3.6666666666666665
6BkR1OS11VsARi1typB3_g,Takos Koreanos,41.9761833591692,-87.6728102141167,2,108,59,25,11,4,207,4.236714975845411,9,4,0,2,2,17,3.9411764705882355
68Rezfdylfccq3B6Xn3JKg,2 Asian Brothers,41.9759499,-87.7096751,1,38,53,18,5,4,118,3.983050847457627,9,1,1,1,1,13,4.230769230769231
0S44DHW394RexDqtFYMQLg,The Bristol,41.9210375,-87.6780084,3,352,313,135,64,35,899,3.982202447163515,44,32,7,16,11,110,3.7454545454545456
V6YhT2K2HQzrNnQKfZuE-g,Ryhana’s Cuisine,41.8689145739179,-87.6833596475275,1,17,8,3,0,0,28,4.5,9,0,0,0,0,9,5.0
7Es7EbTy_s1btAdowLeiPQ,Small Cheval,41.9128236,-87.6816007,2,91,72,28,16,9,216,4.018518518518518,15,3,0,2,1,21,4.380952380952381
YJMFBlFB_dBpEQ370MO92g,Athenian Room,41.9217435,-87.6490466,2,177,191,60,46,35,509,3.8428290766208253,41,25,5,4,5,80,4.1625
ZLOhnb6G0MDbK_nTu6gxIg,Kinmont,41.8953444,-87.6394068,3,106,88,20,21,7,242,4.095041322314049,11,2,0,2,1,16,4.25
N0CzLRbl79f4f6WqjNKM0g,Theory,41.8899748,-87.6286362,2,166,135,75,38,29,443,3.8374717832957113,17,6,0,5,6,34,3.676470588235294
_pvjspuIWHbdkWLPiX9QRQ,Fontano Foods,41.872063,-87.653432,1,64,29,5,3,3,104,4.423076923076923,7,3,1,0,2,13,4.0
afmAYNXgvG5Te9bsvzJPXA,Johnnie’s Snack Shop,41.8849019,-87.6475595,1,38,28,5,2,2,75,4.306666666666667,5,3,0,0,0,8,4.625
ZMmdSK4oObGNCv50tT1OOA,Eva’s Cafe,41.9089825,-87.6384134,1,107,29,7,4,1,148,4.601351351351352,12,7,0,0,0,19,4.631578947368421
sqaHmXuonFpBxJuQFmmsng,Arbor,41.9318546,-87.6921586,2,49,8,4,0,1,62,4.67741935483871,6,0,1,0,0,7,4.714285714285714
q65G-7JIZWy0bTeOzwMzTw,Thai Aree House,41.9459525,-87.7354788,2,86,37,7,1,1,132,4.5606060606060606,10,5,0,0,1,16,4.4375
V4mcn826Kf4HEsBHqZagQw,Zeus Restaurant,41.878153,-87.647737,1,30,58,9,7,4,108,3.9537037037037037,9,1,1,0,1,12,4.416666666666667
6bjsGpmLl9JgbsRZ-JYR-w,Cellar Door Provisions,41.9320491,-87.7035751,2,39,19,9,5,2,74,4.1891891891891895,5,2,0,0,0,7,4.714285714285714
4-ymYbhxthEMWQa2_404FQ,Cafe Urbano,41.9568901653515,-87.723911292851,1,51,16,2,1,3,73,4.52054794520548,5,2,0,0,1,8,4.25
Xj2w1z_cYKGd9RrFxkdB3A,The Big State,41.893192,-87.667531,1,37,12,1,3,2,55,4.4363636363636365,4,0,0,0,0,4,5.0
u4-mGyQ-UOHvqBwMa6Xueg,Aje Cafe,41.9360271,-87.6476682,1,114,41,10,8,6,179,4.391061452513966,21,5,0,4,0,30,4.433333333333334
iv3fycjrqxUgd1BE8qainw,Dena Kitchen,41.924966,-87.7111539,1,35,14,5,2,4,60,4.233333333333333,2,3,0,0,0,5,4.4
RE-hUrq8ZstjW0kAplqlRg,Seven On State,41.8838906,-87.6275643,2,29,36,10,9,2,86,3.941860465116279,3,0,1,0,0,4,4.5
twxzFhgu3GysJfvokEFTzA,B Bim Asian Eatery,41.9055594,-87.6703494,2,15,2,4,3,0,24,4.208333333333333,2,0,0,0,0,2,5.0
M33b4TOoiEcxsDfpDG8bcA,The Squared Circle,41.9257304,-87.6684016,2,99,40,17,11,16,183,4.065573770491803,30,4,2,2,9,47,3.9361702127659575
umGEOhvhbqhh72Mn47a4Zw,El Milagro Tortilla,41.8553487,-87.6629799,1,95,57,22,10,10,194,4.118556701030927,17,8,2,0,5,32,4.0
QaNr4e16T3MW0li-Um2kGQ,Tuscany Restaurant,41.869577,-87.651847,2,108,131,48,26,18,331,3.8610271903323263,26,10,5,4,2,47,4.148936170212766
KU_Ze0TpR2HgKG2OpTh2NA,Slurping Turtle,41.89009,-87.631935,2,181,376,312,128,47,1044,3.4942528735632186,34,26,7,6,14,87,3.689655172413793
dOAj9yI4Y5JsBxQX5D6NBQ,Prosecco,41.895224,-87.634542,3,246,169,57,40,15,527,4.121442125237191,36,22,5,5,5,73,4.082191780821918
AQ_IjTjqESa4vuVYckLLhQ,Shiso,41.9108034,-87.6404819,2,58,108,26,14,8,214,3.9065420560747666,12,8,3,3,2,28,3.892857142857143
igoKL3ikURiKScUSS6cocg,Xocoatl,41.9170075,-87.7213619,1,21,17,9,2,0,49,4.163265306122449,0,0,1,2,0,3,2.3333333333333335
pF4jHr4uyUzTYOdAp0G0mg,Quesadilla La Reyna del Sur,41.9227353,-87.6872333,1,126,78,23,8,10,245,4.2326530612244895,31,7,2,4,3,47,4.25531914893617
lAUWnPtR1PsPox0wtFgVYQ,Hakka Bakka,41.9249654,-87.6605392,1,60,13,5,2,7,87,4.344827586206897,16,5,1,0,2,24,4.375
1uFRbr6B-BiNGtT90sdk0w,Community Tavern,41.954012,-87.748839,3,100,38,12,8,0,158,4.455696202531645,13,5,0,2,1,21,4.285714285714286
2zMvCUbRzGKGWxSI_bcDQQ,Old Lviv,41.896074,-87.683167,1,37,34,5,4,6,86,4.069767441860465,7,5,0,3,2,17,3.7058823529411766
GbC6XO60SlLnlIOTbJE-Ew,Fatso’s Last Stand,41.896014812,-87.6842521942044,1,207,108,45,11,11,382,4.280104712041885,39,13,5,2,4,63,4.285714285714286
XeJkMq4uK4KJgbxL9_Ublg,Bacino’s of Lincoln Park,41.9220898692102,-87.6441773455396,2,130,72,37,21,16,276,4.010869565217392,19,8,3,5,5,40,3.775
5OtAmmypXvuTbkFBCziF_Q,Le Colonial,41.9002333,-87.6270369,3,328,306,134,68,34,870,3.949425287356322,49,37,11,8,9,114,3.956140350877193
Q-u8C-xY6xSaS9rvtEqIyQ,County Barbeque,41.869512,-87.6611439,2,126,100,44,40,20,330,3.824242424242424,15,12,2,2,3,34,4.0
FOO_SegroSvxOMLWywp6ag,Danny’s Egghead Diner,41.9543443259394,-87.6794942125308,2,91,47,10,12,7,167,4.2155688622754495,17,5,0,1,1,24,4.5
wgga2S54iePDvvTZkpLyMA,La Bomba,41.9171957,-87.7078951,1,66,27,14,5,16,128,3.953125,16,5,0,3,5,29,3.8275862068965516
JR5TOTAgxBj4YLfNQ3Dljw,Mindy’s Hot Chocolate,41.9136701,-87.6771786,2,539,650,313,163,83,1748,3.8003432494279177,64,29,14,22,53,182,3.159340659340659
bDBwqeWAEL_FHLmlVLLWSA,Kaishing Asian Restaurant,41.9877738501947,-87.7033444494009,1,15,3,1,0,1,20,4.55,3,0,0,0,0,3,5.0
ji1AtTpLayMdUnENqM0Brw,Cohiba Cuban Cuisine,41.9338424,-87.644272,2,62,34,19,9,4,128,4.1015625,7,1,1,2,2,13,3.6923076923076925
eG64VXdW3RzQhsmTbr-rCw,Chilango Mexican Street Food,41.8691173,-87.663038,1,105,39,14,5,4,167,4.413173652694611,5,1,2,0,0,8,4.375
mWTucUb_YNZNGyt6QSKZmg,SideDoor,41.893544,-87.625047,2,134,93,35,10,16,288,4.107638888888889,15,5,0,1,2,23,4.304347826086956
o4MU9gK7epWUMv2WVW1qrA,Yolk,41.8922875382661,-87.6181584738851,2,323,367,188,64,32,974,3.9086242299794662,28,23,8,8,11,78,3.628205128205128
om-vqH8GMpteU9xlSymPaQ,Loving Heart,41.9619233,-87.6515285,1,81,9,3,0,0,93,4.838709677419355,8,1,0,0,0,9,4.888888888888889
3BL6znoMLs5HyBaowRfuLA,Pho’s Spicier Thai Cuisine,41.942444,-87.670869,1,154,140,31,19,18,362,4.085635359116022,23,11,0,2,4,40,4.175
0BvxoQf0-fAfhUudd-bXFw,Naf Naf Grill,41.887581,-87.624981,1,118,85,12,9,4,228,4.333333333333333,6,4,0,0,2,12,4.0
Y7dqd7fADXj1BOvhRUnYrg,El Faro Restaurant,41.8369072,-87.7233673,1,56,35,18,4,8,121,4.049586776859504,11,4,2,0,2,19,4.157894736842105
_Yx4OcyoYXTiI3xOzNgVyw,Pueblo Nuevo,41.960272,-87.76744,1,128,34,9,5,6,182,4.5,22,5,0,0,5,32,4.21875
UfmcQ0j_HRw0EYMMugJQAQ,Carmela’s Taqueria,41.9691163,-87.6601841,1,61,71,15,12,10,169,3.9526627218934913,14,10,0,0,1,25,4.44
iBK6BbZkgaKijoHqC-FVdQ,Tarboush Mediterranean Grill,41.9108693,-87.6681012,1,32,16,4,7,5,64,3.984375,6,1,0,0,0,7,4.857142857142857
rUV1d6NhrT6wgYmAlJVk7g,The Garage Bar & Sandwiches,41.993379,-87.784547,2,112,69,16,12,9,218,4.206422018348624,22,8,0,1,2,33,4.424242424242424
FzYi3AVHoYZnWXe1BQrQEw,Mott St,41.9071429049228,-87.6674420759082,2,125,80,34,26,12,277,4.0108303249097474,6,4,3,3,1,17,3.6470588235294117
22714mxj2e61k4xfjfqYHw,Sofi Restaurant,41.8738179,-87.6292004,2,88,49,13,10,3,163,4.282208588957055,8,3,1,2,0,14,4.214285714285714
DXwSYgiXqIVNdO9dazel6w,Pequod’s Pizzeria,41.92187,-87.664486,2,1306,754,333,199,161,2753,4.033418089357065,169,84,20,23,57,353,3.8073654390934846
aZqKMhhy_dbQlGTQ91YSbw,Go 4 Food,41.851085,-87.6326203,2,204,161,55,23,35,478,3.99581589958159,48,21,6,3,21,99,3.727272727272727
YqrmZfCDIQ2fPQdLXkWiEA,Cornerstone Cafe,41.9317200792018,-87.6877212524414,1,170,147,34,15,14,380,4.168421052631579,21,10,3,2,7,43,3.8372093023255816
2K5b4gko9aS3rVvu54c22g,Racine Plumbing Bar & Grill,41.9298442,-87.6553587,2,45,49,21,8,1,124,4.040322580645161,3,3,2,1,5,14,2.857142857142857
xXDY18O5C3gzVPNivTVbDg,Nha Hang Viet Nam,41.973457,-87.6560953,1,67,55,14,1,3,140,4.3,9,0,0,0,0,9,5.0
GEpXn9rtTMtIj5NsGFiNQw,The Bad Apple,41.959756,-87.6828215,2,427,470,138,53,31,1119,4.080428954423592,56,43,15,16,12,142,3.8098591549295775
wI-mHhdWh8flIZgt46kpUw,The Artisan Cellar,41.8882441,-87.6353879,1,43,34,1,3,4,85,4.2823529411764705,5,4,0,0,1,10,4.2
WLbaTcWigpVQWDwbCajuhA,Ciao! Cafe & Wine Lounge,41.881575821838,-87.65099037689,2,43,44,10,8,10,115,3.8869565217391306,10,5,0,3,4,22,3.6363636363636362
70jKs0LvwuqaKvkaqVQP9Q,Home Bistro,41.943935,-87.649505,2,414,244,68,35,17,778,4.289203084832905,69,31,4,15,12,131,3.9923664122137406
zipWyPrxNX8m5XFwm3b1lg,Masa Azul,41.9318778,-87.7002477,2,95,74,17,11,4,201,4.218905472636816,17,7,0,0,0,24,4.708333333333333
1GiybV2faVpTt1zw13CzLA,Rangoli,41.910198,-87.68809,2,203,103,36,23,38,403,4.0173697270471465,21,8,4,2,3,38,4.105263157894737
ToVDS0YPKcK1Y8Ww3r7ccA,La Brasa Roja,41.961756,-87.706826,1,91,65,16,6,11,189,4.158730158730159,16,8,1,2,6,33,3.787878787878788
QUQeCZa3Y32b6s31aHJLQA,The Peasantry,41.9321,-87.644335,2,143,111,60,40,43,397,3.6826196473551636,26,4,9,4,10,53,3.6037735849056602
qWFpQt5Lcyz_kg1UkDDmeQ,La Oaxaqueña,41.9426494,-87.7299662,2,59,55,11,8,8,141,4.056737588652482,12,7,2,1,2,24,4.083333333333333
5rLrAjUAnwc6dUrodaEhAw,Runa Japanese,41.9103182940484,-87.6847123075727,2,105,43,26,12,3,189,4.243386243386244,24,5,0,2,0,31,4.645161290322581
PTjBAjRMCxLKAob8Dt5SIA,Chief O’Neill’s Pub & Restaurant,41.944631,-87.705506,2,153,139,43,26,16,377,4.026525198938992,33,13,3,5,20,74,3.4594594594594597
QPr7dxBlnNipJ0R5-GMd-w,Slim’s,41.961707,-87.6798933,1,92,56,4,3,4,159,4.440251572327044,26,9,3,2,1,41,4.390243902439025
wsox4oAdEk94m6YploUfdA,Gemini Bistro,41.9200319,-87.640967,3,103,149,58,29,12,351,3.8603988603988606,22,11,1,9,4,47,3.8085106382978724
3AuSik58k7zu3Ztlmj13Cw,42 grams,41.9669009,-87.6584502,4,41,5,2,1,2,51,4.607843137254902,11,0,1,1,0,13,4.615384615384615
W8bvTzMxbeR928MYz-5QAA,Green Tomato Cafe,41.853257,-87.7192364,1,48,7,4,0,0,59,4.745762711864407,9,1,0,0,0,10,4.9
Mue9yWkRqjBMjB5f0_Vq-Q,Oak + Char,41.8944982,-87.6351642,3,65,67,33,16,10,191,3.842931937172775,6,4,1,0,5,16,3.375
Tdy6sDnyu7Od2kBvlzduAA,Pierogi Heaven,41.8852399,-87.6336693,1,210,168,44,11,2,435,4.317241379310345,22,5,5,1,2,35,4.257142857142857
Tr2b8s55GDgx7cz2VbWC8w,The Harding Tavern,41.9308003,-87.7102403,2,45,59,25,13,13,155,3.7096774193548385,7,5,1,2,2,17,3.764705882352941
JZ0tKgd5u_XqTpGe5ukGbg,Coyotes Restaurant,41.8577556,-87.6634885,1,13,13,8,4,0,38,3.9210526315789473,4,1,0,1,1,7,3.857142857142857
QtgbDggYQtR4AdTmBeAxBQ,Los 3 Panchos,41.932502,-87.658004,1,74,46,16,8,7,151,4.139072847682119,16,5,3,1,2,27,4.185185185185185
apyIymDFbUK7u-Y3V5kmkA,Bavette’s Bar & Boeuf,41.8892796234574,-87.6348227262497,3,778,217,88,42,18,1143,4.482939632545932,64,25,11,8,3,111,4.252252252252252
jxPXmzh6a_JZbLDb1QM27w,Doc B’s,41.8914543,-87.6261804,2,126,72,19,7,2,226,4.384955752212389,5,4,0,1,1,11,4.0
dux6UvpMGJuHquFA3JfR3A,Green Street Smoked Meats,41.883651,-87.648968,2,291,250,76,29,14,660,4.174242424242424,25,15,2,2,2,46,4.282608695652174
ecj6b2CGcThT_1tQSxnStA,The Ogden,41.8795504,-87.668008,2,60,49,20,16,20,165,3.684848484848485,12,5,3,4,8,32,3.28125
8P3vFRfVyvn1LGAlkJOWaQ,Oyster Bah,41.917779,-87.648873,3,24,13,9,3,1,50,4.12,2,1,0,1,0,4,4.0
7LgM-Zotz-rW7RiyAI9XVg,Fat Willy’s Rib Shack,41.9304624,-87.688725,2,304,370,135,71,65,945,3.8222222222222224,32,38,14,11,17,112,3.5089285714285716
JJ_n-4vsY5y_N-wTwaN9Nw,La Encantada,41.9099037,-87.7134639,2,67,60,10,8,1,146,4.260273972602739,18,12,0,1,4,35,4.114285714285714
vb5hLPqsBEPmBsY-77Wl2g,Viaggio Ristorante & Lounge,41.8817858,-87.6608806,2,266,124,31,15,18,454,4.332599118942731,67,12,4,2,3,88,4.568181818181818
LMaoM2Ue2BR_HI9ba3JsZg,The Publican,41.886644,-87.648765,3,908,813,344,163,71,2299,4.010874293170944,93,71,29,23,38,254,3.622047244094488
sAYWV4cA3QrJsV6_u7pcWw,Gyros On The Spit,41.93306,-87.659857,2,106,22,4,6,4,142,4.549295774647887,10,2,0,0,0,12,4.833333333333333
uluVSYUWG2rSw-yqCGIHDg,Tutto Fresco,41.9521074,-87.6494141,2,49,45,19,8,3,124,4.040322580645161,7,2,1,3,2,15,3.6
3HE0HPAOa4kS5y4OhzQfzg,Monti’s,41.968266340068,-87.694936727407,2,229,123,32,8,9,401,4.384039900249377,50,13,4,2,8,77,4.233766233766234
SIpkuonA9o15KGEuy-PTUA,Taqueria El Tapatio,41.924711,-87.733258,1,15,2,0,0,0,17,4.882352941176471,2,0,0,0,0,2,5.0
O6uWHgJzylSjWjPSJKGhnQ,Sultan’s Market,41.910438,-87.679155,1,484,382,120,61,44,1091,4.100824931255729,78,48,11,6,41,184,3.630434782608696
2utBBiZLq0YqcxmiMYySgA,Kaiser Tiger,41.883811,-87.662905,2,57,58,39,32,15,201,3.5472636815920398,5,1,1,4,7,18,2.611111111111111
ZFrWas6Xm0jvf35wZIsUvg,Lavash Mediterranean Grill,41.8828894,-87.6445242,1,21,12,3,2,3,41,4.121951219512195,6,0,0,0,1,7,4.428571428571429
ttDpEi84vz2ZP5H6n8xZAg,Coffee Slasticarna Drina,41.968326,-87.691675,1,26,3,0,0,0,29,4.896551724137931,6,0,0,0,0,6,5.0
1uvWscUUqiO2_Q_aBpeZyA,La Sirena Clandestina,41.887103,-87.651697,2,129,111,35,24,4,303,4.112211221122112,8,5,0,1,1,15,4.2
Vu1iI-olI44EMcNdATYV3w,Poncitlan Jalisco Taqueria,41.9317482,-87.7390907,1,20,5,0,0,1,26,4.653846153846154,3,1,0,0,0,4,4.75
0-rkPnrTODt_veJ_nMVT_w,Sabatino’s Restaurant & Lounge,41.9533094666682,-87.7395818782611,2,209,144,40,31,29,453,4.044150110375276,90,22,6,6,12,136,4.264705882352941
FDUfvqQK8EA2biX3xDPAyg,Coalfire Pizza,41.949181,-87.66369,2,25,14,11,6,1,57,3.982456140350877,0,1,0,1,1,3,2.3333333333333335
1hJYOI26FjCQ-Ce6iKAvug,Cafecito,41.875725,-87.626566,1,532,381,103,37,16,1069,4.287184284377923,54,31,3,6,3,97,4.309278350515464
hbFDXHPMSJld7mSvh0syxQ,Herb,41.980728,-87.660392,3,70,7,5,4,2,88,4.579545454545454,9,2,0,0,0,11,4.818181818181818
j3chLwR9p9Rb-j2KNOpS5Q,Inspiration Kitchens,41.8850168,-87.7140367,2,97,28,4,2,3,134,4.597014925373134,14,7,0,0,0,21,4.666666666666667
e2QX74RGoZFrzig-hkaAkw,L’Appetito,41.8989830004187,-87.6237510761963,1,78,125,44,22,15,284,3.806338028169014,11,10,5,3,2,31,3.806451612903226
61ZW2zyuzjAxt8K12UM3sg,Hala In Restaurant,41.9681622,-87.7439318,2,108,54,19,10,14,205,4.131707317073171,22,6,3,1,2,34,4.323529411764706
ZbXgwfVDjb2tz08FGWmSAA,Folklore Argentine Grill,41.9033624,-87.6799227,2,157,146,60,49,20,432,3.8587962962962963,23,12,5,7,12,59,3.457627118644068
o0DaPvRb4IWH7hUWVCnoGw,Monteverde,41.881913,-87.653021,3,30,17,8,5,5,65,3.953846153846154,3,0,0,0,1,4,4.0
J54uFvc21BslX_jqzIDW5A,Hopsmith Tavern,41.9037362,-87.629377,2,30,32,6,3,11,82,3.817073170731707,2,0,2,1,5,10,2.3
BnuVd40aBq0Z61P3wSSNlw,Twisted Spoke,41.8912954404938,-87.6585463125038,2,141,214,107,53,53,568,3.5933098591549295,23,23,6,6,27,85,3.1058823529411765
g2BZVEeNbFQfruKLDDe-ZQ,Bar Takito,41.8855781,-87.6521285,2,83,77,28,20,8,216,3.9583333333333335,10,6,3,1,0,20,4.25
f0wRHfIKH0V9K_AfiGqPLA,BenjYehuda,41.9277978,-87.6415001,1,27,12,2,4,3,48,4.166666666666667,0,0,1,0,0,1,3.0
vrmONvXOXMQ_RA8kpWQ91Q,Ameritalia,41.8656083,-87.6238097,2,91,33,8,3,0,135,4.57037037037037,12,3,0,0,0,15,4.8
IuFEm-19YYh49T5ZlvwkDA,90 Miles Cuban Café,41.9380249,-87.6858036,1,279,226,71,30,18,624,4.1506410256410255,43,19,7,5,12,86,3.883720930232558
tVt7B3_Ga-IAAcU-7x_h4w,Sophie’s,41.8952336,-87.6246876,2,21,10,7,2,0,40,4.25,1,1,0,1,1,4,3.0
